ROZZ	Chromista	Chromista
BAKF	Chromista	Chromista
IRZA	Chromista	Chromista
IAYV	Chromista	Chromista
BAJW	ChromistaHaptophyceae	Chromista
LXRN	ChromistaHaptophyceae	Chromista
EBWI	ChromistaHaptophyceae	Chromista
RFAD	ChromistaHaptophyceae	Chromista
LLEN	ChromistaHaptophyceae	Chromista
VJED	ChromistaHaptophyceae	Chromista
NMAK	ChromistaHaptophyceae	Chromista
BOGT	ChromistaChrysophyta	Chromista
VKVG	ChromistaChrysophyta	Chromista
DBYD	ChromistaChrysophyta	Chromista
APTP	Chromista	Chromista
LIRF	Chromista	Chromista
FOMH	Chromista	Chromista
HFIK	Chromista	Chromista
FIKG	Chromista	Chromista
RWXW	Chromista	Chromista
LDRY	Chromista	Chromista
YRMA	Chromista	Chromista
JGGD	Chromista	Chromista
VYER	Chromista	Chromista
FSQE	Chromista	Chromista
FIDQ	Chromista	Chromista
RAPY	Chromista	Chromista
SRSQ	Chromista	Chromista
ASZK	Chromista	Chromista
QLMZ	Chromista	Chromista
JCXF	Chromista	Chromista
VRGZ	Chromista	Chromista
ULXR	Chromista	Chromista
Cyame_v1.0	Rhodophyta	Rhodophyta
LLXJ	Rhodophyta	Rhodophyta
JJZR	Rhodophyta	Rhodophyta
RSOF	Rhodophyta	Rhodophyta
RTLC	Rhodophyta	Rhodophyta
PVGP	Rhodophyta	Rhodophyta
OBUY	Rhodophyta	Rhodophyta
ZULJ	Rhodophyta	Rhodophyta
VZWX	Rhodophyta	Rhodophyta
YSBD	Rhodophyta	Rhodophyta
UYFR	Rhodophyta	Rhodophyta
XAXW	Rhodophyta	Rhodophyta
JEBK	Rhodophyta	Rhodophyta
BWVJ	Rhodophyta	Rhodophyta
IHJY	Rhodophyta	Rhodophyta
IEHF	Rhodophyta	Rhodophyta
CKXF	Rhodophyta	Rhodophyta
SBLT	Rhodophyta	Rhodophyta
WEJN	Rhodophyta	Rhodophyta
UGPM	Rhodophyta	Rhodophyta
PYDB	Rhodophyta	Rhodophyta
URSB	Rhodophyta	Rhodophyta
IKIZ	Rhodophyta	Rhodophyta
ZJOJ	Rhodophyta	Rhodophyta
IKWM	Rhodophyta	Rhodophyta
LJPN	Rhodophyta	Rhodophyta
VNAL	Rhodophyta	Rhodophyta
PWKQ	Rhodophyta	Rhodophyta
FTRP	Rhodophyta	Rhodophyta
QFND	Glaucophyta	Glaucophyta
Cyapa_v1.0	Glaucophyta	Glaucophyta
JKHA	Glaucophyta	Glaucophyta
POOW	Glaucophyta	Glaucophyta
PQED	Glaucophyta	Glaucophyta
EGNB	prasinophytes Scourfieldiales	Chlorophyta
JMTE	prasinophytes Pseudoscourfieldiales	Chlorophyta
TNAW	prasinophytes Pyramimonadales	Chlorophyta
XIVI	prasinophytes Pyramimonadales	Chlorophyta
XOAL	Mamiellophyceae	Chlorophyta
BTFM	Mamiellophyceae	Chlorophyta
Micpu_v3.0	Mamiellophyceae	Chlorophyta
QXSZ	Mamiellophyceae	Chlorophyta
Ostlu_v2.0	Mamiellophyceae	Chlorophyta
MCPK	Mamiellophyceae	Chlorophyta
ISIM	Nephroselmidophyceae Nephroselmidales	Chlorophyta
MMKU	Nephroselmidophyceae Nephroselmidales	Chlorophyta
TGNL	prasinophytes Chlorophyta incertae sedis	Chlorophyta
AYPS	Chlorophyta	Chlorophyta
RRSV	Pedinophyceae	Chlorophyta
PUAN	Pedinophyceae	Chlorophyta
FMVB	Chlorodendrales	Chlorophyta
DUMA	Chlorodendrales	Chlorophyta
HVNO	Chlorodendrales	Chlorophyta
HHXJ	Chlorodendrales	Chlorophyta
PFUD	Trebouxiophyceae	Chlorophyta
MFYC	Trebouxiophyceae	Chlorophyta
MNCB	Trebouxiophyceae	Chlorophyta
JQFK	Trebouxiophyceae	Chlorophyta
BILC	Trebouxiophyceae	Chlorophyta
AKCR	Trebouxiophyceae	Chlorophyta
Chlva_v1.0	Trebouxiophyceae	Chlorophyta
EEJO	Trebouxiophyceae	Chlorophyta
WCLV	Trebouxiophyceae	Chlorophyta
WXRI	Trebouxiophyceae	Chlorophyta
EATP	Trebouxiophyceae	Chlorophyta
ZNUM	Trebouxiophyceae	Chlorophyta
NKXU	Trebouxiophyceae	Chlorophyta
GXBM	Trebouxiophyceae	Chlorophyta
QYXY	Trebouxiophyceae	Chlorophyta
ETGN	Trebouxiophyceae	Chlorophyta
NATT	Ulvophyceae	Chlorophyta
YDCQ	Ulvophyceae	Chlorophyta
VHIJ	Ulvophyceae	Chlorophyta
VBLH	Ulvophyceae	Chlorophyta
ALZF	Ulvophyceae	Chlorophyta
NSTT	Ulvophyceae	Chlorophyta
KADG	Ulvophyceae	Chlorophyta
JIWJ	Ulvophyceae	Chlorophyta
AJAU	Ulvophyceae	Chlorophyta
LETF	Ulvophyceae	Chlorophyta
CBNG	Ulvophyceae	Chlorophyta
GJIY	Ulvophyceae	Chlorophyta
KSFK	Ulvophyceae	Chlorophyta
LSHT	Ulvophyceae	Chlorophyta
NQYP	Ulvophyceae	Chlorophyta
OQON	Ulvophyceae	Chlorophyta
OAEZ	Ulvophyceae	Chlorophyta
CQQP	Ulvophyceae	Chlorophyta
GYBH	Ulvophyceae	Chlorophyta
JTIG	Ulvophyceae	Chlorophyta
BAZF	Chlorophyceae	Chlorophyta
DVYE	Chlorophyceae	Chlorophyta
SDPC	Chlorophyceae	Chlorophyta
IJMT	Chlorophyceae	Chlorophyta
RAWF	Chlorophyceae	Chlorophyta
ISGT	Chlorophyceae	Chlorophyta
VFIV	Chlorophyceae	Chlorophyta
JMUI	Chlorophyceae	Chlorophyta
DZPJ	Chlorophyceae	Chlorophyta
MXDS	Chlorophyceae	Chlorophyta
ENAU	Chlorophyceae	Chlorophyta
FOYQ	Chlorophyceae	Chlorophyta
BZSH	Chlorophyceae	Chlorophyta
OTQG	Chlorophyceae	Chlorophyta
MWAN	Chlorophyceae	Chlorophyta
PZIF	Chlorophyceae	Chlorophyta
VJDZ	Chlorophyceae	Chlorophyta
XKWQ	Chlorophyceae	Chlorophyta
XTON	Chlorophyceae	Chlorophyta
VIAU	Chlorophyceae	Chlorophyta
RUIF	Chlorophyceae	Chlorophyta
FXHG	Chlorophyceae	Chlorophyta
UTRE	Chlorophyceae	Chlorophyta
AOUJ	Chlorophyceae	Chlorophyta
LBRP	Chlorophyceae	Chlorophyta
AJUW	Chlorophyceae	Chlorophyta
XDLL	Chlorophyceae	Chlorophyta
OFUE	Chlorophyceae	Chlorophyta
IRYH	Chlorophyceae	Chlorophyta
QWRA	Chlorophyceae	Chlorophyta
USIX	Chlorophyceae	Chlorophyta
JKKI	Chlorophyceae	Chlorophyta
BCYF	Chlorophyceae	Chlorophyta
Chlre_v5.5	Chlorophyceae	Chlorophyta
IHOI	Chlorophyceae	Chlorophyta
KUJU	Chlorophyceae	Chlorophyta
ISPU	Chlorophyceae	Chlorophyta
RNAT	Chlorophyceae	Chlorophyta
RYJX	Chlorophyceae	Chlorophyta
Volca_v2.0	Chlorophyceae	Chlorophyta
JWGT	Chlorophyceae	Chlorophyta
WRSL	Chlorophyceae	Chlorophyta
ZIVZ	Chlorophyceae	Chlorophyta
LNIL	Chlorophyceae	Chlorophyta
ACRY	Chlorophyceae	Chlorophyta
TSBQ	Chlorophyceae	Chlorophyta
GFUR	Chlorophyceae	Chlorophyta
JRGZ	Chlorophyceae	Chlorophyta
VALZ	Chlorophyceae	Chlorophyta
MULF	Chlorophyceae	Chlorophyta
KFEB	Chlorophyceae	Chlorophyta
GUBD	Chlorophyceae	Chlorophyta
ZLQE	Chlorophyceae	Chlorophyta
PRIQ	Chlorophyceae	Chlorophyta
QRTH	Chlorophyceae	Chlorophyta
ZFXU	Chlorophyceae	Chlorophyta
SYJM	Chlorophyceae	Chlorophyta
UKUC	Chlorophyceae	Chlorophyta
RHVC	Chlorophyceae	Chlorophyta
WDWX	Chlorophyceae	Chlorophyta
ZDIZ	Chlorophyceae	Chlorophyta
XMCL	prasinophytes/Prasinococcales Prasinococcales	Chlorophyta
HYHN	prasinophytes/Prasinococcales Prasinococcales	Chlorophyta
XJGM	prasinophytes/Prasinococcales Prasinococcales	Chlorophyta
KYIO	Mesostigmatophyceae	Streptophyte Algae
NNHQ	Streptophytaincertaesedis	Streptophyte Algae
AZZW	Chlorokybales	Streptophyte Algae
BFIK	Klebsormidiophyceae	Streptophyte Algae
FPCO	Klebsormidiophyceae	Streptophyte Algae
Klefl_v1.0	Klebsormidiales	Streptophyte Algae
FQLP	Klebsormidiophyceae	Streptophyte Algae
Chabr_v0.1	Charophyceae	Streptophyte Algae
MWXT	Charophyceae	Streptophyte Algae
DRGY	Coleochaetophyceae	Streptophyte Algae
QPDY	Coleochaetophyceae	Streptophyte Algae
VQBJ	Coleochaetophyceae	Streptophyte Algae
TPHT	Zygnemophyceae	Streptophyte Algae
HAOX	Zygnemophyceae	Streptophyte Algae
WSJO	Zygnemophyceae	Streptophyte Algae
WDCW	Zygnemophyceae	Streptophyte Algae
YOXI	Zygnemophyceae	Streptophyte Algae
VAZE	Zygnemophyceae	Streptophyte Algae
RPGL	Zygnemophyceae	Streptophyte Algae
HKZW	Zygnemophyceae	Streptophyte Algae
ZRMT	Zygnemophyceae	Streptophyte Algae
JOJQ	Zygnemophyceae	Streptophyte Algae
NBYP	Zygnemophyceae	Streptophyte Algae
MFZO	Zygnemophyceae	Streptophyte Algae
FFGR	Zygnemophyceae	Streptophyte Algae
KMNX	Zygnemophyceae	Streptophyte Algae
SNOX	Zygnemophyceae	Streptophyte Algae
XRTZ	Zygnemophyceae	Streptophyte Algae
KEYW	Zygnemophyceae	Streptophyte Algae
DRFX	Zygnemophyceae	Streptophyte Algae
AEKF	Zygnemophyceae	Streptophyte Algae
YSQT	Zygnemophyceae	Streptophyte Algae
RPQV	Zygnemophyceae	Streptophyte Algae
HIDG	Zygnemophyceae	Streptophyte Algae
RQFE	Zygnemophyceae	Streptophyte Algae
GYRP	Zygnemophyceae	Streptophyte Algae
MNNM	Zygnemophyceae	Streptophyte Algae
ISHC	Zygnemophyceae	Streptophyte Algae
QWFV	Zygnemophyceae	Streptophyte Algae
DFDS	Zygnemophyceae	Streptophyte Algae
GGWH	Zygnemophyceae	Streptophyte Algae
WCQU	Zygnemophyceae	Streptophyte Algae
BHBK	Zygnemophyceae	Streptophyte Algae
RPRU	Zygnemophyceae	Streptophyte Algae
MCHJ	Zygnemophyceae	Streptophyte Algae
GBGT	Zygnemophyceae	Streptophyte Algae
MOYY	Zygnemophyceae	Streptophyte Algae
STKJ	Zygnemophyceae	Streptophyte Algae
WDGV	Zygnemophyceae	Streptophyte Algae
ANON	Hornworts	Hornworts
BSNI	Hornworts	Hornworts
TWUW	Hornworts	Hornworts
FAJB	Hornworts	Hornworts
WCZB	Hornworts	Hornworts
WEEQ	Hornworts	Hornworts
AKXB	Hornworts	Hornworts
UCRN	Hornworts	Hornworts
TCBC	Hornworts	Hornworts
DXOU	Hornworts	Hornworts
HERT	Liverworts	Liverworts
TXVB	Liverworts	Liverworts
ILBQ	Liverworts	Liverworts
WJLO	Liverworts	Liverworts
TFYI	Liverworts	Liverworts
JPYU	Liverworts	Liverworts
Marpo_v1.0	Liverworts	Liverworts
HMHL	Liverworts	Liverworts
PIUF	Liverworts	Liverworts
JHFI	Liverworts	Liverworts
YFGP	Liverworts	Liverworts
NRWZ	Liverworts	Liverworts
HPXA	Liverworts	Liverworts
TGKW	Liverworts	Liverworts
BNCU	Liverworts	Liverworts
KRUQ	Liverworts	Liverworts
UUHD	Liverworts	Liverworts
LGOW	Liverworts	Liverworts
RTMU	Liverworts	Liverworts
WZYK	Liverworts	Liverworts
YBQN	Liverworts	Liverworts
IRBN	Liverworts	Liverworts
OFTV	Liverworts	Liverworts
SKQD	Mosses	Mosses
GOWD	Mosses	Mosses
RCBT	Mosses	Mosses
UHLI	Mosses	Mosses
WOGB	Mosses	Mosses
HVBQ	Mosses	Mosses
SZYG	Mosses	Mosses
ZTHV	Mosses	Mosses
HRWG	Mosses	Mosses
AWOI	Mosses	Mosses
KEFD	Mosses	Mosses
YEPO	Mosses	Mosses
Phypa_v3.0	Mosses	Mosses
ZQRI	Mosses	Mosses
BPSG	Mosses	Mosses
ABCD	Mosses	Mosses
RDOO	Mosses	Mosses
VMXJ	Mosses	Mosses
RGKI	Mosses	Mosses
NGTD	Mosses	Mosses
FFPD	Mosses	Mosses
GRKU	Mosses	Mosses
YWNF	Mosses	Mosses
ORKS	Mosses	Mosses
BGXB	Mosses	Mosses
XWHK	Mosses	Mosses
JMXW	Mosses	Mosses
CMEQ	Mosses	Mosses
WNGH	Mosses	Mosses
DHWX	Mosses	Mosses
QKQO	Mosses	Mosses
IGUH	Mosses	Mosses
ZACW	Mosses	Mosses
TAVP	Mosses	Mosses
EEMJ	Mosses	Mosses
LNSF	Mosses	Mosses
QMWB	Mosses	Mosses
TMAJ	Mosses	Mosses
MIRS	Mosses	Mosses
WSPM	Mosses	Mosses
JADL	Mosses	Mosses
VBMM	Mosses	Mosses
ZZEI	Lycophytes	Lycophytes
CBAE	Lycophytes	Lycophytes
GAON	Lycophytes	Lycophytes
YHZW	Lycophytes	Lycophytes
GKAG	Lycophytes	Lycophytes
UPMJ	Lycophytes	Lycophytes
ULKT	Lycophytes	Lycophytes
PQTO	Lycophytes	Lycophytes
XNXF	Lycophytes	Lycophytes
WAFT	Lycophytes	Lycophytes
ENQF	Lycophytes	Lycophytes
PKOX	Lycophytes	Lycophytes
PYHZ	Lycophytes	Lycophytes
KUXM	Lycophytes	Lycophytes
ZFGK	Lycophytes	Lycophytes
JKAA	Lycophytes	Lycophytes
ZYCD	Lycophytes	Lycophytes
KJYC	Lycophytes	Lycophytes
LGDQ	Lycophytes	Lycophytes
ABIJ	Lycophytes	Lycophytes
Selmo_v1.0	Lycophytes	Lycophytes
ZZOL	Lycophytes	Lycophytes
JVSZ	EusporangiateMonilophytes	Monilophytes
CAPN	EusporangiateMonilophytes	Monilophytes
DFHO	EusporangiateMonilophytes	Monilophytes
UGNK	EusporangiateMonilophytes	Monilophytes
NHCM	EusporangiateMonilophytes	Monilophytes
QVMR	EusporangiateMonilophytes	Monilophytes
ALVQ	EusporangiateMonilophytes	Monilophytes
DJSE	EusporangiateMonilophytes	Monilophytes
EEAQ	EusporangiateMonilophytes	Monilophytes
BEGM	EusporangiateMonilophytes	Monilophytes
RFMZ	LeptosporangiateMonilophytes	Monilophytes
UOMY	LeptosporangiateMonilophytes	Monilophytes
VIBO	LeptosporangiateMonilophytes	Monilophytes
MEKP	LeptosporangiateMonilophytes	Monilophytes
QIAD	LeptosporangiateMonilophytes	Monilophytes
PBUU	LeptosporangiateMonilophytes	Monilophytes
CQPW	LeptosporangiateMonilophytes	Monilophytes
CVEG	LeptosporangiateMonilophytes	Monilophytes
KIIX	LeptosporangiateMonilophytes	Monilophytes
GANB	LeptosporangiateMonilophytes	Monilophytes
EWXK	LeptosporangiateMonilophytes	Monilophytes
UWOD	LeptosporangiateMonilophytes	Monilophytes
PNZO	LeptosporangiateMonilophytes	Monilophytes
VVRN	LeptosporangiateMonilophytes	Monilophytes
YIXP	LeptosporangiateMonilophytes	Monilophytes
NOKI	LeptosporangiateMonilophytes	Monilophytes
PIVW	LeptosporangiateMonilophytes	Monilophytes
UJTT	LeptosporangiateMonilophytes	Monilophytes
FLTD	LeptosporangiateMonilophytes	Monilophytes
POPJ	LeptosporangiateMonilophytes	Monilophytes
WQML	LeptosporangiateMonilophytes	Monilophytes
NDUV	LeptosporangiateMonilophytes	Monilophytes
SKYV	LeptosporangiateMonilophytes	Monilophytes
BMJR	LeptosporangiateMonilophytes	Monilophytes
WCLG	LeptosporangiateMonilophytes	Monilophytes
XDDT	LeptosporangiateMonilophytes	Monilophytes
GSXD	LeptosporangiateMonilophytes	Monilophytes
YCKE	LeptosporangiateMonilophytes	Monilophytes
ZXJO	LeptosporangiateMonilophytes	Monilophytes
DCDT	LeptosporangiateMonilophytes	Monilophytes
MTGC	LeptosporangiateMonilophytes	Monilophytes
WGTU	LeptosporangiateMonilophytes	Monilophytes
RFRB	LeptosporangiateMonilophytes	Monilophytes
FQGQ	LeptosporangiateMonilophytes	Monilophytes
JBLI	LeptosporangiateMonilophytes	Monilophytes
NWWI	LeptosporangiateMonilophytes	Monilophytes
OQWW	LeptosporangiateMonilophytes	Monilophytes
ORJE	LeptosporangiateMonilophytes	Monilophytes
UJWU	LeptosporangiateMonilophytes	Monilophytes
ZQYU	LeptosporangiateMonilophytes	Monilophytes
YLJA	LeptosporangiateMonilophytes	Monilophytes
GYFU	LeptosporangiateMonilophytes	Monilophytes
CJNT	LeptosporangiateMonilophytes	Monilophytes
IXLH	LeptosporangiateMonilophytes	Monilophytes
KJZG	LeptosporangiateMonilophytes	Monilophytes
BMIF	LeptosporangiateMonilophytes	Monilophytes
PSKY	LeptosporangiateMonilophytes	Monilophytes
HEGQ	LeptosporangiateMonilophytes	Monilophytes
HNDZ	LeptosporangiateMonilophytes	Monilophytes
LHLE	LeptosporangiateMonilophytes	Monilophytes
RICC	LeptosporangiateMonilophytes	Monilophytes
YOWV	LeptosporangiateMonilophytes	Monilophytes
XXHP	LeptosporangiateMonilophytes	Monilophytes
OCZL	LeptosporangiateMonilophytes	Monilophytes
MROH	LeptosporangiateMonilophytes	Monilophytes
YQEC	LeptosporangiateMonilophytes	Monilophytes
YJJY	LeptosporangiateMonilophytes	Monilophytes
HTFH	LeptosporangiateMonilophytes	Monilophytes
VITX	LeptosporangiateMonilophytes	Monilophytes
FCHS	LeptosporangiateMonilophytes	Monilophytes
UFJN	LeptosporangiateMonilophytes	Monilophytes
URCP	LeptosporangiateMonilophytes	Monilophytes
AFPO	LeptosporangiateMonilophytes	Monilophytes
SGTW	Ginkgoales Ginkgoales	Gymnosperms
Ginbi_v1.0	Ginkgoales Ginkgoales	Gymnosperms
XZUY	Cycadales Cycadales	Gymnosperms
WLIC	Cycadales Cycadales	Gymnosperms
GNQG	Cycadales Cycadales	Gymnosperms
KAWQ	Cycadales Cycadales	Gymnosperms
VDAO	Gnetales	Gymnosperms
TOXE	Gnetales	Gymnosperms
GTHK	Gnetales	Gymnosperms
Gnemo_v1.0	Gnetales	Gymnosperms
GGEA	Pinales	Gymnosperms
VSRH	Pinales	Gymnosperms
JUWL	Pinales	Gymnosperms
AQFM	Pinales	Gymnosperms
GAMH	Pinales	Gymnosperms
AREG	Pinales	Gymnosperms
WVWN	Pinales	Gymnosperms
IOVS	Pinales	Gymnosperms
NPRL	Pinales	Gymnosperms
AWQB	Pinales	Gymnosperms
IIOL	Pinales	Gymnosperms
Pinta_v2.0	Pinales	Gymnosperms
DZQM	Pinales	Gymnosperms
JBND	Pinales	Gymnosperms
MFTM	Pinales	Gymnosperms
XTZO	Pinales	Gymnosperms
RSCE	Pinales	Gymnosperms
MIXZ	Pinales	Gymnosperms
ACWS	Pinales	Gymnosperms
EGLZ	Pinales	Gymnosperms
KLGF	Pinales	Gymnosperms
OWFC	Pinales	Gymnosperms
JRNA	Pinales	Gymnosperms
BBDD	Pinales	Gymnosperms
JZVE	Pinales	Gymnosperms
ZQWM	Pinales	Gymnosperms
CDFR	Pinales	Gymnosperms
QCGM	Pinales	Gymnosperms
MHGD	Pinales	Gymnosperms
HILW	Pinales	Gymnosperms
FMWZ	Pinales	Gymnosperms
IZGN	Pinales	Gymnosperms
ROWR	Pinales	Gymnosperms
QHBI	Pinales	Gymnosperms
SCEB	Pinales	Gymnosperms
XLGK	Pinales	Gymnosperms
UUJS	Pinales	Gymnosperms
VGSX	Pinales	Gymnosperms
YFZK	Pinales	Gymnosperms
IAJW	Pinales	Gymnosperms
EFMS	Pinales	Gymnosperms
HQOM	Pinales	Gymnosperms
NVGZ	Pinales	Gymnosperms
BTTS	Pinales	Gymnosperms
YLPM	Pinales	Gymnosperms
ZYAX	Pinales	Gymnosperms
WWSS	Pinales	Gymnosperms
ZQVF	Pinales	Gymnosperms
QSNJ	Pinales	Gymnosperms
XIRK	Pinales	Gymnosperms
NRXL	Pinales	Gymnosperms
QFAE	Pinales	Gymnosperms
HBGV	Pinales	Gymnosperms
GMHZ	Pinales	Gymnosperms
OXGJ	Pinales	Gymnosperms
FHST	Pinales	Gymnosperms
ETCJ	Pinales	Gymnosperms
YYPE	Pinales	Gymnosperms
OVIJ	Pinales	Gymnosperms
AUDE	Pinales	Gymnosperms
GKCZ	Pinales	Gymnosperms
IFLI	Pinales	Gymnosperms
RMMV	Pinales	Gymnosperms
JDQB	Pinales	Gymnosperms
VFYZ	Pinales	Gymnosperms
NKIN	Pinales	Gymnosperms
UEVI	Pinales	Gymnosperms
AIGO	Pinales	Gymnosperms
XMGP	Pinales	Gymnosperms
QNGJ	Pinales	Gymnosperms
FRPM	Pinales	Gymnosperms
CGDN	Pinales	Gymnosperms
XQSG	Pinales	Gymnosperms
BUWV	Pinales	Gymnosperms
URDJ	BasalAngiosperms	ANA grade
Ambtr_v1.0.27	BasalAngiosperms	ANA grade
PZRT	BasalAngiosperms	ANA grade
WTKZ	BasalAngiosperms	ANA grade
FZJL	BasalAngiosperms	ANA grade
VZCI	BasalAngiosperms	ANA grade
NWMY	BasalAngiosperms	ANA grade
MTII	Monocots	Monocots
DWZT	Monocots	Monocots
COCP	Monocots	Monocots
BYQM	Monocots	Monocots
Spipo_v2	Monocots	Monocots
MFIN	Monocots	Monocots
YMES	Monocots	Monocots
OCWZ	Monocots	Monocots
QOXT	Monocots	Monocots
SILJ	Monocots	Monocots
VBHQ	Monocots	Monocots
DGXS	Monocots	Monocots
VVVV	Monocots	Monocots
NSPR	Monocots	Monocots
Elagu_v2.0	Monocots	Monocots
HWUP	Monocots	Monocots
HXJE	Monocots	Monocots
Musac_v1.0	Monocots	Monocots
XHHU	Monocots	Monocots
UOEL	Monocots	Monocots
LSKK	Monocots	Monocots
LEMW	Monocots	Monocots
BDJQ	Monocots	Monocots
JNUB	Monocots	Monocots
TZNS	Monocots	Monocots
BYPY	Monocots	Monocots
PPQR	Monocots	Monocots
BRUD	Monocots	Monocots
CIEA	Monocots	Monocots
XPAF	Monocots	Monocots
PWSG	Monocots	Monocots
WBIB	Monocots	Monocots
BSTR	Monocots	Monocots
WXNT	Monocots	Monocots
Orysa_v7.0	Monocots	Monocots
IADP	Monocots	Monocots
RMVB	Monocots	Monocots
HATH	Monocots	Monocots
YXNR	Monocots	Monocots
EFCZ	Monocots	Monocots
RCAH	Monocots	Monocots
YLWW	Monocots	Monocots
YPIC	Monocots	Monocots
ROEI	Monocots	Monocots
Sorbi_v2.1	Monocots	Monocots
SOHV	Monocots	Monocots
WCOR	Monocots	Monocots
XBKS	Monocots	Monocots
ZMGN	Monocots	Monocots
BPKH	Monocots	Monocots
NNOK	Monocots	Monocots
BXAY	Monocots	Monocots
XUAB	Monocots	Monocots
VQYB	Monocots	Monocots
ZENX	Monocots	Monocots
AFLV	Monocots	Monocots
OOSO	Monocots	Monocots
MWYQ	Monocots	Monocots
THEW	Monocots	Monocots
GDKK	Monocots	Monocots
QNPH	Monocots	Monocots
NHIX	Monocots	Monocots
THDM	Monocots	Monocots
JSAG	Monocots	Monocots
CNTZ	Monocots	Monocots
MTHW	Monocots	Monocots
XZME	Monocots	Monocots
LELS	Monocots	Monocots
VTUS	Monocots	Monocots
EMJJ	Monocots	Monocots
YJUG	Monocots	Monocots
KYNE	Monocots	Monocots
RDYY	Monocots	Monocots
LTZF	Monocots	Monocots
SART	Monocots	Monocots
JVBR	Monocots	Monocots
FCEL	Monocots	Monocots
WTDE	Monocots	Monocots
BLAJ	Monocots	Monocots
JHUL	Monocots	Monocots
PRFO	Monocots	Monocots
GJPF	Monocots	Monocots
KBXS	Monocots	Monocots
TRRQ	Monocots	Monocots
DMIN	Monocots	Monocots
ZKPF	Monocots	Monocots
LDME	Monocots	Monocots
JDTY	Monocots	Monocots
DPFW	Monocots	Monocots
IXEM	Monocots	Monocots
SVTS	Monocots	Monocots
KOFB	Monocots	Monocots
PLBZ	Monocots	Monocots
CMCY	Monocots	Monocots
KXSK	Monocots	Monocots
ICNN	Monocots	Monocots
YBML	Monocots	Monocots
MUMD	Monocots	Monocots
FGRF	Monocots	Monocots
ONBE	Monocots	Monocots
MVRF	Monocots	Monocots
LSJW	Monocots	Monocots
TCYS	Monocots	Monocots
RQZP	Monocots	Monocots
HOKG	Monocots	Monocots
UZXL	Monocots	Monocots
XFJG	Monocots	Monocots
RCUX	Monocots	Monocots
WZFE	Chloranthales Chloranthales	Chloranthales
OSHQ	Chloranthales Chloranthales	Chloranthales
SJEV	Magnoliids	Magnoliids
WKSU	Magnoliids	Magnoliids
PAWA	Magnoliids	Magnoliids
QDVW	Magnoliids	Magnoliids
CSSK	Magnoliids	Magnoliids
OPDF	Magnoliids	Magnoliids
MUNP	Magnoliids	Magnoliids
XSZI	Magnoliids	Magnoliids
OBPL	Magnoliids	Magnoliids
WBOD	Magnoliids	Magnoliids
XQWC	Magnoliids	Magnoliids
DHPO	Magnoliids	Magnoliids
PSJT	Magnoliids	Magnoliids
YZRI	Magnoliids	Magnoliids
FALI	Magnoliids	Magnoliids
WPHN	Magnoliids	Magnoliids
MAQO	Magnoliids	Magnoliids
WAIL	Magnoliids	Magnoliids
BSVG	Magnoliids	Magnoliids
KRJP	Magnoliids	Magnoliids
VYLQ	Magnoliids	Magnoliids
WIGA	Magnoliids	Magnoliids
KAYP	Magnoliids	Magnoliids
ABSS	Magnoliids	Magnoliids
BCGB	Magnoliids	Magnoliids
NPND	BasalAngiosperms	ANA grade
QTJY	BasalEudicots Ranunculales	CRPT grade
CCID	BasalEudicots Ranunculales	CRPT grade
WFBF	BasalEudicots Ranunculales	CRPT grade
YHFG	BasalEudicots Ranunculales	CRPT grade
VGHH	BasalEudicots Ranunculales	CRPT grade
UPOG	BasalEudicots Ranunculales	CRPT grade
ZUHO	BasalEudicots Ranunculales	CRPT grade
GBVZ	BasalEudicots Ranunculales	CRPT grade
Aquco_v1.1	BasalEudicots	CRPT grade
NMGG	BasalEudicots Ranunculales	CRPT grade
AUGV	BasalEudicots Ranunculales	CRPT grade
ZGQD	BasalEudicots Ranunculales	CRPT grade
UDHA	BasalEudicots Ranunculales	CRPT grade
EVOD	BasalEudicots Ranunculales	CRPT grade
XHKT	BasalEudicots Ranunculales	CRPT grade
XMVD	BasalEudicots Ranunculales	CRPT grade
IRAF	BasalEudicots Ranunculales	CRPT grade
SSDU	BasalEudicots Ranunculales	CRPT grade
BEKN	BasalEudicots Ranunculales	CRPT grade
RQNK	BasalEudicots Ranunculales	CRPT grade
QCOU	BasalEudicots Ranunculales	CRPT grade
AALA	BasalEudicots	CRPT grade
FAKD	BasalEudicots	CRPT grade
Nelnu_v1.0	BasalEudicots	CRPT grade
VQFW	BasalEudicots	CRPT grade
GRRW	BasalEudicots	CRPT grade
RQUG	BasalEudicots	CRPT grade
SIIK	BasalEudicots	CRPT grade
IWMW	BasalEudicots	CRPT grade
SWOH	BasalEudicots	CRPT grade
XMQO	BasalEudicots	CRPT grade
EHNF	BasalEudicots	CRPT grade
XKPS	CoreEudicots Santalales	Santalales
VGVI	CoreEudicots Santalales	Santalales
XGFU	CoreEudicots Santalales	Santalales
RSPO	CoreEudicots Santalales	Santalales
QKMG	CoreEudicots Santalales	Santalales
BSEY	CoreEudicots Santalales	Santalales
BGZG	CoreEudicots/Rosids	Rosids
Vitvi_Genoscope.12X	CoreEudicots/Rosids	Rosids
SZPD	CoreEudicots/Rosids	Rosids
BBBA	CoreEudicots/Rosids	Rosids
HTIP	CoreEudicots Saxifragales	Saxifragales
FYTP	CoreEudicots Saxifragales	Saxifragales
NUZN	CoreEudicots Saxifragales	Saxifragales
YKQR	CoreEudicots Saxifragales	Saxifragales
HQRJ	CoreEudicots Saxifragales	Saxifragales
OMDH	CoreEudicots Saxifragales	Saxifragales
IUSR	CoreEudicots Saxifragales	Saxifragales
TOKV	CoreEudicots Saxifragales	Saxifragales
KWGC	CoreEudicots Saxifragales	Saxifragales
DRIL	CoreEudicots Saxifragales	Saxifragales
ZJUL	CoreEudicots Saxifragales	Saxifragales
UWFU	CoreEudicots Saxifragales	Saxifragales
SYHW	CoreEudicots Saxifragales	Saxifragales
FCBJ	CoreEudicots Saxifragales	Saxifragales
YKFU	CoreEudicots Saxifragales	Saxifragales
UHBY	CoreEudicots Saxifragales	Saxifragales
CIAC	CoreEudicots Saxifragales	Saxifragales
OOVX	CoreEudicots Saxifragales	Saxifragales
CKKR	CoreEudicots Saxifragales	Saxifragales
ERIA	CoreEudicots Saxifragales	Saxifragales
SLOI	CoreEudicots Saxifragales	Saxifragales
DAYQ	CoreEudicots Saxifragales	Saxifragales
CTSS	CoreEudicots Saxifragales	Saxifragales
VYGG	CoreEudicots/Rosids	Rosids
PTLU	CoreEudicots/Rosids	Rosids
HDWF	CoreEudicots/Rosids	Rosids
YGCX	CoreEudicots/Rosids	Rosids
AXAF	CoreEudicots/Rosids	Rosids
OCTM	CoreEudicots/Rosids	Rosids
NNGU	CoreEudicots/Rosids	Rosids
RBYC	CoreEudicots/Rosids	Rosids
ZHEE	CoreEudicots/Rosids	Rosids
WVEF	CoreEudicots/Rosids	Rosids
EILE	CoreEudicots/Rosids	Rosids
CQMG	CoreEudicots/Rosids	Rosids
KYAD	CoreEudicots/Rosids	Rosids
BJSW	CoreEudicots/Rosids	Rosids
AQGE	CoreEudicots/Rosids	Rosids
EDHN	CoreEudicots/Rosids	Rosids
XVJB	CoreEudicots/Rosids	Rosids
WKCY	CoreEudicots/Rosids	Rosids
ACFP	CoreEudicots/Rosids	Rosids
DHAW	CoreEudicots/Rosids	Rosids
IANR	CoreEudicots/Rosids	Rosids
QNOC	CoreEudicots/Rosids	Rosids
SQCF	CoreEudicots/Rosids	Rosids
XFFT	CoreEudicots/Rosids	Rosids
SXCE	CoreEudicots/Rosids	Rosids
TJQY	CoreEudicots/Rosids	Rosids
Prupe_v1.0	CoreEudicots/Rosids	Rosids
NCVK	CoreEudicots/Rosids	Rosids
ZPKK	CoreEudicots/Rosids	Rosids
QIEH	CoreEudicots/Rosids	Rosids
VCIN	CoreEudicots/Rosids	Rosids
EAVM	CoreEudicots/Rosids	Rosids
BLVL	CoreEudicots/Rosids	Rosids
TJLC	CoreEudicots/Rosids	Rosids
SVVG	CoreEudicots/Rosids	Rosids
HENI	CoreEudicots/Rosids	Rosids
UZWG	CoreEudicots/Rosids	Rosids
NHUA	CoreEudicots/Rosids	Rosids
INSP	CoreEudicots/Rosids	Rosids
DXQW	CoreEudicots/Rosids	Rosids
LNER	CoreEudicots/Rosids	Rosids
LWDA	CoreEudicots/Rosids	Rosids
CWZU	CoreEudicots/Rosids	Rosids
OHAE	CoreEudicots/Rosids	Rosids
OQHZ	CoreEudicots/Rosids	Rosids
RKLL	CoreEudicots/Rosids	Rosids
JETM	CoreEudicots/Rosids	Rosids
RKFX	CoreEudicots/Rosids	Rosids
QZXQ	CoreEudicots/Rosids	Rosids
VHZV	CoreEudicots/Rosids	Rosids
GEHT	CoreEudicots/Rosids	Rosids
KZED	CoreEudicots/Rosids	Rosids
XOOE	CoreEudicots/Rosids	Rosids
ZCDJ	CoreEudicots/Rosids	Rosids
PJSX	CoreEudicots/Rosids	Rosids
ZSSR	CoreEudicots/Rosids	Rosids
SLYR	CoreEudicots/Rosids	Rosids
CMFF	CoreEudicots/Rosids	Rosids
TTRG	CoreEudicots/Rosids	Rosids
VLNB	CoreEudicots/Rosids	Rosids
NXOH	CoreEudicots/Rosids	Rosids
SUAK	CoreEudicots/Rosids	Rosids
Phavu_v1.0	CoreEudicots/Rosids	Rosids
TVSH	CoreEudicots/Rosids	Rosids
KEGA	CoreEudicots/Rosids	Rosids
RMWJ	CoreEudicots/Rosids	Rosids
JTQQ	CoreEudicots/Rosids	Rosids
PEZP	CoreEudicots/Rosids	Rosids
KNMB	CoreEudicots/Rosids	Rosids
HJMP	CoreEudicots/Rosids	Rosids
MYMP	CoreEudicots/Rosids	Rosids
ZHMB	CoreEudicots/Rosids	Rosids
UDUT	CoreEudicots/Rosids	Rosids
KVAY	CoreEudicots/Rosids	Rosids
AJJE	CoreEudicots/Rosids	Rosids
SWGX	CoreEudicots/Rosids	Rosids
WWQZ	CoreEudicots/Rosids	Rosids
NEBM	CoreEudicots/Rosids	Rosids
FGDU	CoreEudicots/Rosids	Rosids
Eucgr_v1.1	CoreEudicots/Rosids	Rosids
AYMT	CoreEudicots/Rosids	Rosids
RJNQ	CoreEudicots/Rosids	Rosids
YNUE	CoreEudicots/Rosids	Rosids
FEDW	CoreEudicots/Rosids	Rosids
UJGI	CoreEudicots/Rosids	Rosids
TLCA	CoreEudicots/Rosids	Rosids
JKNQ	CoreEudicots/Rosids	Rosids
AXNH	CoreEudicots/Rosids	Rosids
PMTB	CoreEudicots/Rosids	Rosids
SJAN	CoreEudicots/Rosids	Rosids
EQYT	CoreEudicots/Rosids	Rosids
HKMQ	CoreEudicots/Rosids	Rosids
CJGZ	CoreEudicots/Rosids	Rosids
DZLN	CoreEudicots/Rosids	Rosids
GVCB	CoreEudicots/Rosids	Rosids
ROLB	CoreEudicots/Rosids	Rosids
IDAU	CoreEudicots/Rosids	Rosids
ZINQ	CoreEudicots/Rosids	Rosids
BZDF	CoreEudicots/Rosids	Rosids
ARYD	CoreEudicots/Rosids	Rosids
IMZV	CoreEudicots/Rosids	Rosids
KBRW	CoreEudicots/Rosids	Rosids
YHLF	CoreEudicots/Rosids	Rosids
IHCQ	CoreEudicots/Rosids	Rosids
MFEA	CoreEudicots/Rosids	Rosids
RHAU	CoreEudicots/Rosids	Rosids
PXYR	CoreEudicots/Rosids	Rosids
PAZJ	CoreEudicots/Rosids	Rosids
VVPY	CoreEudicots/Rosids	Rosids
XNLP	CoreEudicots/Rosids	Rosids
Manes_v4.1	CoreEudicots/Rosids	Rosids
YGAT	CoreEudicots/Rosids	Rosids
VNMY	CoreEudicots/Rosids	Rosids
RPPC	CoreEudicots/Rosids	Rosids
ZTLR	CoreEudicots/Rosids	Rosids
RVGH	CoreEudicots/Rosids	Rosids
NJLF	CoreEudicots/Rosids	Rosids
LPGY	CoreEudicots/Rosids	Rosids
COAQ	CoreEudicots/Rosids	Rosids
EZZT	CoreEudicots/Rosids	Rosids
SIZE	CoreEudicots/Rosids	Rosids
ZIWB	CoreEudicots/Rosids	Rosids
Poptr_v3.0	CoreEudicots/Rosids	Rosids
INQX	CoreEudicots/Rosids	Rosids
RZTJ	CoreEudicots/Rosids	Rosids
LFOG	CoreEudicots/Rosids	Rosids
TDTF	CoreEudicots/Rosids	Rosids
GLVK	CoreEudicots/Rosids	Rosids
IEPQ	CoreEudicots/Rosids	Rosids
KKDQ	CoreEudicots/Rosids	Rosids
XPBC	CoreEudicots/Rosids	Rosids
CKDK	CoreEudicots/Rosids	Rosids
TVCU	CoreEudicots/Rosids	Rosids
FWCQ	CoreEudicots/Rosids	Rosids
OSIP	CoreEudicots/Rosids	Rosids
BNDE	CoreEudicots/Rosids	Rosids
NFXV	CoreEudicots/Rosids	Rosids
ZBVT	CoreEudicots/Rosids	Rosids
HBUQ	CoreEudicots/Rosids	Rosids
AXPJ	CoreEudicots/Rosids	Rosids
KCPT	CoreEudicots/Rosids	Rosids
TXMP	CoreEudicots/Rosids	Rosids
VXOD	CoreEudicots/Rosids	Rosids
HNCF	CoreEudicots/Rosids	Rosids
MYVH	CoreEudicots/Rosids	Rosids
POZS	CoreEudicots/Rosids	Rosids
OODC	CoreEudicots/Rosids	Rosids
BVOF	CoreEudicots/Rosids	Rosids
BHYC	CoreEudicots/Rosids	Rosids
AEPI	CoreEudicots/Rosids	Rosids
JHCN	CoreEudicots/Rosids	Rosids
TIUZ	CoreEudicots/Rosids	Rosids
YZVJ	CoreEudicots/Rosids	Rosids
THHD	CoreEudicots/Rosids	Rosids
WWKL	CoreEudicots/Rosids	Rosids
OBTI	CoreEudicots/Rosids	Rosids
WAXR	CoreEudicots/Rosids	Rosids
VFFP	CoreEudicots/Rosids	Rosids
HBHB	CoreEudicots/Rosids	Rosids
BCAA	CoreEudicots/Rosids	Rosids
YUOM	CoreEudicots/Rosids	Rosids
FCCA	CoreEudicots/Rosids	Rosids
JSZD	CoreEudicots/Rosids	Rosids
UHJR	CoreEudicots/Rosids	Rosids
UVDC	CoreEudicots/Rosids	Rosids
RJIM	CoreEudicots/Rosids	Rosids
QICX	CoreEudicots/Rosids	Rosids
IKFD	CoreEudicots/Rosids	Rosids
PUDI	CoreEudicots/Rosids	Rosids
AWJM	CoreEudicots/Rosids	Rosids
KPTE	CoreEudicots/Rosids	Rosids
PKMO	CoreEudicots/Rosids	Rosids
WMUK	CoreEudicots/Rosids	Rosids
ATFX	CoreEudicots/Rosids	Rosids
Theca_v1.1	CoreEudicots/Rosids	Rosids
WYIG	CoreEudicots/Rosids	Rosids
OLXF	CoreEudicots/Rosids	Rosids
ZSAB	CoreEudicots/Rosids	Rosids
MYZV	CoreEudicots/Rosids	Rosids
HYZL	CoreEudicots/Rosids	Rosids
CZPV	CoreEudicots/Rosids	Rosids
Carpa_ASGPBv0.4	CoreEudicots/Rosids	Rosids
CRNC	CoreEudicots/Rosids	Rosids
DZTK	CoreEudicots/Rosids	Rosids
JOIS	CoreEudicots/Rosids	Rosids
SWPE	CoreEudicots/Rosids	Rosids
UAXP	CoreEudicots/Rosids	Rosids
RTTY	CoreEudicots/Rosids	Rosids
QSKP	CoreEudicots/Rosids	Rosids
LVUS	CoreEudicots/Rosids	Rosids
UPZX	CoreEudicots/Rosids	Rosids
VDKG	CoreEudicots/Rosids	Rosids
Arath_TAIR10	CoreEudicots/Rosids	Rosids
CSUV	CoreEudicots/Rosids	Rosids
VMNH	CoreEudicots/Rosids	Rosids
IPWB	CoreEudicots/Rosids	Rosids
TZWR	CoreEudicots/Rosids	Rosids
GTSV	CoreEudicots/Rosids	Rosids
HABV	CoreEudicots/Rosids	Rosids
LJQF	CoreEudicots/Rosids	Rosids
LAPO	CoreEudicots/Rosids	Rosids
BXBF	CoreEudicots/Rosids	Rosids
UVQL	CoreEudicots/Rosids	Rosids
WQUF	CoreEudicots Caryophyllales	Caryophyllales
FYSJ	CoreEudicots Caryophyllales	Caryophyllales
WOBD	CoreEudicots Caryophyllales	Caryophyllales
CVDF	CoreEudicots Caryophyllales	Caryophyllales
RUUB	CoreEudicots Caryophyllales	Caryophyllales
YNFJ	CoreEudicots Caryophyllales	Caryophyllales
RXEN	CoreEudicots Caryophyllales	Caryophyllales
TJES	CoreEudicots Caryophyllales	Caryophyllales
FZQN	CoreEudicots Caryophyllales	Caryophyllales
OLES	CoreEudicots Caryophyllales	Caryophyllales
SKNL	CoreEudicots Caryophyllales	Caryophyllales
SHEZ	CoreEudicots Caryophyllales	Caryophyllales
WGET	CoreEudicots Caryophyllales	Caryophyllales
FVXD	CoreEudicots Caryophyllales	Caryophyllales
Betvu_v1.1	CoreEudicots Caryophyllales	Caryophyllales
SMMC	CoreEudicots Caryophyllales	Caryophyllales
CBJR	CoreEudicots Caryophyllales	Caryophyllales
AAXJ	CoreEudicots Caryophyllales	Caryophyllales
ONLQ	CoreEudicots Caryophyllales	Caryophyllales
WMLW	CoreEudicots Caryophyllales	Caryophyllales
XSSD	CoreEudicots Caryophyllales	Caryophyllales
PDQH	CoreEudicots Caryophyllales	Caryophyllales
HDSY	CoreEudicots Caryophyllales	Caryophyllales
CUTE	CoreEudicots Caryophyllales	Caryophyllales
BWRK	CoreEudicots Caryophyllales	Caryophyllales
ZBPY	CoreEudicots Caryophyllales	Caryophyllales
EYRD	CoreEudicots Caryophyllales	Caryophyllales
OHKC	CoreEudicots Caryophyllales	Caryophyllales
BJKT	CoreEudicots Caryophyllales	Caryophyllales
OMYK	CoreEudicots Caryophyllales	Caryophyllales
BERS	CoreEudicots Caryophyllales	Caryophyllales
GJNX	CoreEudicots Caryophyllales	Caryophyllales
HZTS	CoreEudicots Caryophyllales	Caryophyllales
EDIT	CoreEudicots Caryophyllales	Caryophyllales
GIWN	CoreEudicots Caryophyllales	Caryophyllales
MRKX	CoreEudicots Caryophyllales	Caryophyllales
BKQU	CoreEudicots Caryophyllales	Caryophyllales
AZBL	CoreEudicots Caryophyllales	Caryophyllales
SFKQ	CoreEudicots Caryophyllales	Caryophyllales
JAFJ	CoreEudicots Caryophyllales	Caryophyllales
JGAB	CoreEudicots Caryophyllales	Caryophyllales
ZBTA	CoreEudicots Caryophyllales	Caryophyllales
VJPU	CoreEudicots Caryophyllales	Caryophyllales
DVXD	CoreEudicots Caryophyllales	Caryophyllales
EGOS	CoreEudicots Caryophyllales	Caryophyllales
KJAA	CoreEudicots Caryophyllales	Caryophyllales
NXTS	CoreEudicots Caryophyllales	Caryophyllales
RNBN	CoreEudicots Caryophyllales	Caryophyllales
SCAO	CoreEudicots Caryophyllales	Caryophyllales
CTYH	CoreEudicots Caryophyllales	Caryophyllales
LKKX	CoreEudicots Caryophyllales	Caryophyllales
CPKP	CoreEudicots Caryophyllales	Caryophyllales
JLOV	CoreEudicots Caryophyllales	Caryophyllales
UQCB	CoreEudicots Caryophyllales	Caryophyllales
EZGR	CoreEudicots Caryophyllales	Caryophyllales
LLQV	CoreEudicots Caryophyllales	Caryophyllales
BYNZ	CoreEudicots Caryophyllales	Caryophyllales
KDCH	CoreEudicots Caryophyllales	Caryophyllales
CPLT	CoreEudicots Caryophyllales	Caryophyllales
LDEL	CoreEudicots Caryophyllales	Caryophyllales
IWIS	CoreEudicots Caryophyllales	Caryophyllales
GCYL	CoreEudicots Caryophyllales	Caryophyllales
QUTB	BasalEudicots	CRPT grade
HAEU	BasalEudicots	CRPT grade
VTLJ	CoreEudicots/Asterids	Asterids
ZETY	CoreEudicots/Asterids	Asterids
QURC	CoreEudicots/Asterids	Asterids
VUSY	CoreEudicots/Asterids	Asterids
BFJL	CoreEudicots/Asterids	Asterids
FWBF	CoreEudicots/Asterids	Asterids
BNTL	CoreEudicots/Asterids	Asterids
JEXA	CoreEudicots/Asterids	Asterids
YSRZ	CoreEudicots/Asterids	Asterids
FNEN	CoreEudicots/Asterids	Asterids
WVMY	CoreEudicots/Asterids	Asterids
OXYP	CoreEudicots/Asterids	Asterids
BEFC	CoreEudicots/Asterids	Asterids
WRPP	CoreEudicots/Asterids	Asterids
KVFU	CoreEudicots/Asterids	Asterids
VKJD	CoreEudicots/Asterids	Asterids
PTFA	CoreEudicots/Asterids	Asterids
ODDO	CoreEudicots/Asterids	Asterids
DAAD	CoreEudicots/Asterids	Asterids
NGRR	CoreEudicots/Asterids	Asterids
JPDJ	CoreEudicots/Asterids	Asterids
AXBO	CoreEudicots/Asterids	Asterids
ADHK	CoreEudicots/Asterids	Asterids
UFHF	CoreEudicots/Asterids	Asterids
QAUE	CoreEudicots/Asterids	Asterids
HUSX	CoreEudicots/Asterids	Asterids
LRTN	CoreEudicots/Asterids	Asterids
SERM	CoreEudicots/Asterids	Asterids
AVJK	CoreEudicots/Asterids	Asterids
WXVX	CoreEudicots/Asterids	Asterids
PPPZ	CoreEudicots/Asterids	Asterids
CLNU	CoreEudicots/Asterids	Asterids
CLMX	CoreEudicots/Asterids	Asterids
ZJRC	CoreEudicots/Asterids	Asterids
HLJG	CoreEudicots/Asterids	Asterids
CAQZ	CoreEudicots/Asterids	Asterids
GSZA	CoreEudicots/Asterids	Asterids
JTRM	CoreEudicots/Asterids	Asterids
FFFY	CoreEudicots/Asterids	Asterids
SBZH	CoreEudicots/Asterids	Asterids
QIKZ	CoreEudicots/Asterids	Asterids
MVSE	CoreEudicots/Asterids	Asterids
NTEO	CoreEudicots/Asterids	Asterids
SALZ	CoreEudicots/Asterids	Asterids
OINM	CoreEudicots/Asterids	Asterids
SUVN	CoreEudicots/Asterids	Asterids
EDBB	CoreEudicots/Asterids	Asterids
AJFN	CoreEudicots/Asterids	Asterids
WEQK	CoreEudicots/Asterids	Asterids
CWYJ	CoreEudicots/Asterids	Asterids
TQKZ	CoreEudicots/Asterids	Asterids
IHPC	CoreEudicots/Asterids	Asterids
IZLO	CoreEudicots/Asterids	Asterids
FXGI	CoreEudicots/Asterids	Asterids
AUIP	CoreEudicots/Asterids	Asterids
TPEM	CoreEudicots/Asterids	Asterids
GIOY	CoreEudicots/Asterids	Asterids
IXVJ	CoreEudicots/Asterids	Asterids
HUQC	CoreEudicots/Asterids	Asterids
CFRN	CoreEudicots/Asterids	Asterids
EYKJ	CoreEudicots/Asterids	Asterids
JNKW	CoreEudicots/Asterids	Asterids
RFSD	CoreEudicots/Asterids	Asterids
DDRL	CoreEudicots/Asterids	Asterids
FUPX	CoreEudicots/Asterids	Asterids
KFZY	CoreEudicots/Asterids	Asterids
KGJF	CoreEudicots/Asterids	Asterids
BMSE	CoreEudicots/Asterids	Asterids
DUQG	CoreEudicots/Asterids	Asterids
OAGK	CoreEudicots/Asterids	Asterids
GUMF	CoreEudicots/Asterids	Asterids
DOVJ	CoreEudicots/Asterids	Asterids
XRCX	CoreEudicots/Asterids	Asterids
TEZA	CoreEudicots/Asterids	Asterids
DESP	CoreEudicots/Asterids	Asterids
MHYG	CoreEudicots/Asterids	Asterids
AFQQ	CoreEudicots/Asterids	Asterids
DUNJ	CoreEudicots/Asterids	Asterids
UBLN	CoreEudicots/Asterids	Asterids
BIDT	CoreEudicots/Asterids	Asterids
AQZD	CoreEudicots/Asterids	Asterids
YRBQ	CoreEudicots/Asterids	Asterids
LYPZ	CoreEudicots/Asterids	Asterids
JYMN	CoreEudicots/Asterids	Asterids
UYED	CoreEudicots/Asterids	Asterids
NVSO	CoreEudicots/Asterids	Asterids
QXWF	CoreEudicots/Asterids	Asterids
HXCD	CoreEudicots/Asterids	Asterids
ZCUA	CoreEudicots/Asterids	Asterids
JEPE	CoreEudicots/Asterids	Asterids
GIPR	CoreEudicots/Asterids	Asterids
SZUO	CoreEudicots/Asterids	Asterids
QACK	CoreEudicots/Asterids	Asterids
DFYF	CoreEudicots/Asterids	Asterids
ASMV	CoreEudicots/Asterids	Asterids
SXML	CoreEudicots/Asterids	Asterids
QZZU	CoreEudicots/Asterids	Asterids
AHRN	CoreEudicots/Asterids	Asterids
CPOC	CoreEudicots/Asterids	Asterids
ALUC	CoreEudicots/Asterids	Asterids
IZNU	CoreEudicots/Asterids	Asterids
ERWT	CoreEudicots/Asterids	Asterids
OQBM	CoreEudicots/Asterids	Asterids
QSLH	CoreEudicots/Asterids	Asterids
NHAG	CoreEudicots/Asterids	Asterids
XQRV	CoreEudicots/Asterids	Asterids
VXKB	CoreEudicots/Asterids	Asterids
EMBR	CoreEudicots/Asterids	Asterids
NAUM	CoreEudicots/Asterids	Asterids
MKZR	CoreEudicots/Asterids	Asterids
BOLZ	CoreEudicots/Asterids	Asterids
OSMU	CoreEudicots/Asterids	Asterids
LWCK	CoreEudicots/Asterids	Asterids
AIOU	CoreEudicots/Asterids	Asterids
JNVS	CoreEudicots/Asterids	Asterids
UGJI	CoreEudicots/Asterids	Asterids
NMDZ	CoreEudicots/Asterids	Asterids
LQJY	CoreEudicots/Asterids	Asterids
GHLP	CoreEudicots/Asterids	Asterids
DLJZ	CoreEudicots/Asterids	Asterids
Solly_iTAGv2.3	CoreEudicots/Asterids	Asterids
DLAI	CoreEudicots/Asterids	Asterids
DKFZ	CoreEudicots/Asterids	Asterids
YQIJ	CoreEudicots/Asterids	Asterids
EMAL	CoreEudicots/Asterids	Asterids
SMUR	CoreEudicots/Asterids	Asterids
HANM	CoreEudicots/Asterids	Asterids
DIHD	CoreEudicots/Asterids	Asterids
XVRU	CoreEudicots/Asterids	Asterids
NIGS	CoreEudicots/Asterids	Asterids
OEKO	CoreEudicots/Asterids	Asterids
IDGE	CoreEudicots/Asterids	Asterids
OUER	CoreEudicots/Asterids	Asterids
MDJK	CoreEudicots/Asterids	Asterids
JWEY	CoreEudicots/Asterids	Asterids
MZOB	CoreEudicots/Asterids	Asterids
ABEH	CoreEudicots/Asterids	Asterids
WQRD	CoreEudicots/Asterids	Asterids
ZSGF	CoreEudicots/Asterids	Asterids
KTWL	CoreEudicots/Asterids	Asterids
PCNH	CoreEudicots/Asterids	Asterids
HGSM	CoreEudicots/Asterids	Asterids
KPUM	CoreEudicots/Asterids	Asterids
ECTD	CoreEudicots/Asterids	Asterids
GGJD	CoreEudicots/Asterids	Asterids
UOYN	CoreEudicots/Asterids	Asterids
QEHE	CoreEudicots/Asterids	Asterids
MGVU	CoreEudicots/Asterids	Asterids
EDEQ	CoreEudicots/Asterids	Asterids
JGYZ	CoreEudicots/Asterids	Asterids
JCLQ	CoreEudicots/Asterids	Asterids
YFQX	CoreEudicots/Asterids	Asterids
YADI	CoreEudicots/Asterids	Asterids
DSUV	CoreEudicots/Asterids	Asterids
COBX	CoreEudicots/Asterids	Asterids
MZLD	CoreEudicots/Asterids	Asterids
TORX	CoreEudicots/Asterids	Asterids
KTAR	CoreEudicots/Asterids	Asterids
YZGX	CoreEudicots/Asterids	Asterids
DCCI	CoreEudicots/Asterids	Asterids
RWKR	CoreEudicots/Asterids	Asterids
DTNC	CoreEudicots/Asterids	Asterids
CLRW	CoreEudicots/Asterids	Asterids
YRHD	CoreEudicots/Asterids	Asterids
XISJ	CoreEudicots/Asterids	Asterids
GNRI	CoreEudicots/Asterids	Asterids
PTBJ	CoreEudicots/Asterids	Asterids
YKZB	CoreEudicots/Asterids	Asterids
GDZS	CoreEudicots/Asterids	Asterids
EJBY	CoreEudicots/Asterids	Asterids
XXYA	CoreEudicots/Asterids	Asterids
SIBR	CoreEudicots/Asterids	Asterids
GRFT	CoreEudicots/Asterids	Asterids
XRLM	CoreEudicots/Asterids	Asterids
WOHL	CoreEudicots/Asterids	Asterids
EDXZ	CoreEudicots/Asterids	Asterids
ZRIN	CoreEudicots/Asterids	Asterids
HRUR	CoreEudicots/Asterids	Asterids
MXFG	CoreEudicots/Asterids	Asterids
JCMU	CoreEudicots/Asterids	Asterids
PCGJ	CoreEudicots/Asterids	Asterids
AYIY	CoreEudicots/Asterids	Asterids
NBMW	CoreEudicots/Asterids	Asterids
WEAC	CoreEudicots/Asterids	Asterids
GCFE	CoreEudicots/Asterids	Asterids
PSHB	CoreEudicots/Asterids	Asterids
MQIV	CoreEudicots/Asterids	Asterids
TKEK	CoreEudicots/Asterids	Asterids
UTQR	CoreEudicots/Asterids	Asterids
XAYK	CoreEudicots/Asterids	Asterids
Mimgu_v2.0	CoreEudicots/Asterids	Asterids
UMUL	CoreEudicots/Asterids	Asterids
OWAS	CoreEudicots/Asterids	Asterids
EJCM	CoreEudicots/Asterids	Asterids
VYDM	CoreEudicots/Asterids	Asterids
FAMO	CoreEudicots/Asterids	Asterids
FROP	CoreEudicots/Asterids	Asterids
DMLT	CoreEudicots/Asterids	Asterids
ATYL	CoreEudicots/Asterids	Asterids
GETL	CoreEudicots/Asterids	Asterids
EAAA	CoreEudicots/Asterids	Asterids
SNNC	CoreEudicots/Asterids	Asterids
UCNM	CoreEudicots/Asterids	Asterids
LRRR	CoreEudicots/Asterids	Asterids
GNPX	CoreEudicots/Asterids	Asterids
RTNA	CoreEudicots/Asterids	Asterids
BAHE	CoreEudicots/Asterids	Asterids
FYUH	CoreEudicots/Asterids	Asterids
TAGM	CoreEudicots/Asterids	Asterids
FDMM	CoreEudicots/Asterids	Asterids
EQDA	CoreEudicots/Asterids	Asterids
IYDF	CoreEudicots/Asterids	Asterids
WHNV	CoreEudicots/Asterids	Asterids
XMBA	CoreEudicots/Asterids	Asterids
PHCE	CoreEudicots/Asterids	Asterids
PUCW	CoreEudicots/Asterids	Asterids
FUMQ	CoreEudicots/Asterids	Asterids
