
AALA	Meliosma cuneifolia
AAXJ	Atriplex prostrata
ABCD	Racomitrium elongatum
ABEH	Heliotropium greggii
ABIJ	Selaginella cf. pallescens
ABSS	Sassafras albidum
ACFP	Boehmeria nivea
ACRY	Pteromonas sp.
ACWS	Araucaria sp.
ADHK	Galax urceolata
AEKF	Penium margaritaceum
AEPI	Linum leonii
AFLV	Xerophyllum asphodeloides
AFPO	Athyrium sp.
AFQQ	Inula helenium
AHRN	Cuscuta pentagona
AIGO	Chamaecyparis lawsoniana
AIOU	Brugmansia sanguinea
AJAU	Helicodictyon planctonicum
AJFN	Myodocarpus sp.
AJJE	Terminalia neotaliala
AJUW	Chloromonas rosae
AKCR	Parachlorella kessleri
AKXB	Phaeomegaceros coriaceus
ALUC	Ipomoea quamoclit
ALVQ	Tmesipteris parva
ALZF	Halochlorococcum marinum
ANON	Leiosporoceros dussii
AOUJ	Chlamydomonas sp.
APTP	Ishige okamurae
AQFM	Pseudolarix amabilis
AQGE	Humulus lupulus
AQZD	Flaveria pringlei
AREG	Nothotsuga longibracteata
ARYD	Oenothera laciniata
ASMV	Ilex vomitoria
ASZK	Punctaria latifolia
ATFX	Muntingia calabura
ATYL	Scutellaria montana
AUDE	Widdringtonia cedarbergensis
AUGV	Capnoides sempervirens
AUIP	Phelline lucida
AVJK	Cavendishia cuatrecasasii
AWJM	Edgeworthia papyrifera
AWOI	Diphyscium foliosum
AWQB	Picea engelmannii
AXAF	Thladiantha villosula
AXBO	Sinojackia xylocarpa
AXNH	Oenothera filiformis
AXPJ	Linum flavum
AYIY	Ruellia brittoniana
AYMT	Eucalyptus leucoxylon
AYPS	Chlorophyta incertae sedis
AZBL	Petiveria alliacea
AZZW	Chlorokybus atmophyticus
'Ambtr_v1.0.27'	Amborella_trichopoda
'Aquco_v1.1'	Aquilegia coerulea
Arath_TAIR10	Arabidopsis_thaliana
BAHE	Solenostemon scutellarioides
BAJW	Isochrysis sp.
BAKF	Cryptomonas curvata
BAZF	Chaetopeltis orbicularis
BBBA	Tetrastigma obtectum
BBDD	Microstrobos fitzgeraldii
BCAA	Kirkia wilmsii
BCGB	Cinnamomum camphora
BCYF	Chlamydomonas cribrum
BDJQ	Zingiber officinale
BEFC	Manilkara zapota
BEGM	Botrypus virginianus
BEKN	Papaver rhoeas
BERS	Zaleya pentandra
BFIK	Entransia fimbriata
BFJL	Cornus florida
BGXB	Plagiomnium insigne
BGZG	Cissus quadrangularis
BHBK	Cosmarium tinctum
BHYC	Linum lewisii
BIDT	Flaveria cronquistii
BILC	Prototheca wickerhamii
BJKT	Delosperma echinatum
BJSW	Cannabis sativa
BKQU	Phytolacca americana
BLAJ	Hemerocallis spp.
BLVL	Sorbus koehneana
BMIF	Asplenium cf. x lucrosum
BMJR	Adiantum raddianum
BMSE	Senecio rowleyanus
BNCU	Radula lindenbergiana
BNDE	Hypericum perforatum
BNTL	Souroubea exauriculata
BOGT	Mallomonas sp.
BOLZ	Atropa belladonna
BPKH	Neurachne annularis
BPSG	Scouleria aquatica
BRUD	Typha latifolia
BSEY	Daenikera sp.
BSNI	Anthoceros agrestis
BSTR	Chondropetalum tectorum
BSVG	Gyrocarpus americanus
BTFM	Monomastix opisthostigma
BTTS	Austrotaxus spicata
BUWV	Platycladus orientalis
BVOF	Linum perenne
BWRK	Alternanthera sessilis
BWVJ	Betaphycus philippinensis
BXAY	Neurachne minor
BXBF	Draba sachalinensis
BYNZ	Portulaca umbraticola
BYPY	Brocchinia reducta
BYQM	Posidonia australis
BZDF	Oenothera biennis
BZSH	Golenkinia longispicula
'Betvu_v1.1'	Beta_vulgaris
CAPN	Equisetum diffusum
CAQZ	Symphoricarpos sp.
CBAE	Huperzia myrsinites
CBJR	Atriplex rosea
CBNG	Planophila laetevirens
CCID	Akebia trifoliata
CDFR	Manoao colensoi
CFRN	Carthamus lanatus
CGDN	Tetraclinis sp.
CIAC	Bergenia sp.
CIEA	Juncus inflexus
CJGZ	Oenothera nana
CJNT	Polypodium glycyrrhiza
CKDK	Ochna serrulata
CKKR	Astilbe chinensis
CKXF	Ahnfeltiopsis flabelliformis
CLMX	Escallonia rubra
CLNU	Escallonia sp. cv. Newport
CLRW	Bacopa caroliniana
CMCY	Hesperaloe parviflora
CMEQ	Orthotrichum lyellii
CMFF	Lupinus polyphyllus
CNTZ	Oncidium sphacelatum
COAQ	Malesherbia fasciculata
COBX	Polypremum procumbens
COCP	Triglochin maritima
CPKP	Lophophora williamsii
CPLT	Portulaca grandiflora
CPOC	Convolvulus arvensis
CQMG	Ulmus alata
CQPW	Anemia tomentosa
CQQP	Ochlochaete sp.
CRNC	Limnanthes douglasii
CSSK	Houttuynia cordata
CSUV	Cochlearia officinalis
CTSS	Tellima breviflora
CTYH	Basella alba
CUTE	Blutaparon vermiculare
CVDF	Simmondsia chinensis
CVEG	Azolla cf. caroliniana
CWYJ	Heracleum lanatum
CWZU	Betula pendula
Cyapa_v1.0	Cyanophora paradoxa
CZPV	Moringa oleifera
'Carpa_ASGPBv0.4'	Carica_papaya
'Chabr_v0.1'	Chara braunii
'Chlre_v5.5'	Chlamydomonas reinhardtii 
'Chlva_v1.0'	Chlorella variabilis
'Cyame_v1.0'	Cyanidioschyzon_merolae
DAAD	Ardisia revoluta
DAYQ	Mitella pentandra
DBYD	Synura petersenii
DCCI	Calceolaria pinifolia
DCDT	Gaga arizonica
DDRL	Tragopogon dubius
DESP	Erigeron canadensis
DFDS	Desmidium aptogonum
DFHO	Danaea nodosa
DFYF	Ilex sp.
DGXS	Freycinetia multiflora
DHAW	Geum quellyon
DHPO	Eupomatia bennettii
DHWX	Fontinalis antipyretica
DIHD	Heliotropium tenellum
DJSE	Ophioglossum petiolatum
DKFZ	Mertensia paniculata
DLAI	Solanum lasiophyllum
DLJZ	Solanum ptychanthum
DMIN	Phycella aff. cyrtanthoides
DMLT	Vitex agnus-castus
DOVJ	Leontopodium alpinum
DPFW	Zephyranthes treatiae
DRFX	Closterium lunula
DRGY	Chaetosphaeridium globosum
DRIL	Kalanchoe crenato-diagremontiana
DSUV	Asclepias curassavica
DTNC	Sinningia tuberosa
DUMA	Tetraselmis cordiformis
DUNJ	Helenium autumnale
DUQG	Tanacetum parthenium
DVXD	Allionia incarnata
DVYE	Oedogonium cardiacum
DWZT	Sagittaria latifolia
DXOU	Nothoceros aenigmaticus
DXQW	Juglans nigra
DZLN	Oenothera picensis
DZPJ	Cylindrocapsa geminella
DZQM	Pinus radiata
DZTK	Batis maritima
EAAA	Marrubium vulgare
EATP	Microthamnion kuetzingianum
EAVM	Amelanchier canadensis
EBWI	Rebecca salina
ECTD	Gentiana acaulis
EDBB	Polyscias fruticosa
EDEQ	Wrightia natalensis
EDHN	Ficus religiosa
EDIT	Sesuvium verrucosum
EDXZ	Schlegelia violacea
EEAQ	Sceptridium dissectum
EEJO	Ettlia(?) oleoabundans
EEMJ	Thuidium delicatulum
EFCZ	Eleusine coracana
EFMS	Torreya taxifolia
EGLZ	Prumnopitys andina
EGNB	Scourfieldia sp.
EGOS	Allionia incarnata
EHNF	Dillenia indica
EILE	Rhamnus japonica
EJBY	Anticharis glandulosa
EJCM	Lindenbergia philippensis
EMAL	Ehretia acuminata
EMBR	Ipomoea pubescens
EMJJ	Borya sphaerocephala
ENAU	Spermatozopsis similis
ENQF	Lycopodium annotinum
EQDA	Salvia spp.
EQYT	Oenothera berlandieri
ERIA	Heuchera sanguinea
ERWT	Ipomoea coccinea
ETCJ	Pilgerodendron uviferum
ETGN	Botryococcus braunii
EVOD	Eschscholzia californica
EWXK	Thyrsopteris elegans
EYKJ	Silybum marianum
EYRD	Alternanthera tenella
EZGR	Portulaca oleracea
EZZT	Passiflora edulis
'Elagu_v2.0'	Elaeis guineensis
'Eucgr_v1.1'	Eucalyptus grandis
FAJB	Paraphymatoceros hallii
FAKD	Nelumbo sp.
FALI	Calycanthus floridus
FAMO	Conopholis americana
FCBJ	Saxifraga stolonifera
FCCA	Boswellia sacra
FCEL	Phormium tenax
FCHS	Deparia lobato-crenata
FDMM	Rosmarinus officinalis
FEDW	Epilobium sp.
FFFY	Valeriana officinalis
FFGR	Netrium digitus
FFPD	Ceratodon purpureus
FGDU	Syzygium paniculatum
FGRF	Asparagus densiflorus
FHST	Taxodium distichum
FIDQ	Undaria pinnatifida
FIKG	Sargassum henslowianum
FLTD	Pteris ensiformis
FMVB	Scherffelia dubia
FMWZ	Dacrycarpus compactus
FNEN	Phlox sp.
FOMH	Sargassum integerrimum
FOYQ	Microspora cf. tumidula
FPCO	Interfilum paradoxum
FQGQ	Polystichum acrostichoides
FQLP	Klebsormidium subtile
FROP	Epifagus virginiana
FRPM	Calocedrus decurrens
FSQE	Desmarestia viridis
FTRP	Gracilaria chouae
FUMQ	Nepeta cataria
FUPX	Tragopogon pratensis
FVXD	Beta maritima
FWBF	Alangium chinense
FWCQ	Garcinia oblongifolia
FXGI	Stylidium adnatum
FXHG	Hafniomonas reticulata
FYSJ	Polygonum convolvulus
FYTP	Daphniphyllum macropodum
FYUH	Lavandula angustifolia
FZJL	Austrobaileya scandens
FZQN	Silene latifolia
GAMH	Tsuga heterophylla
GANB	Alsophila pinulosa
GAON	Huperzia squarrosa
GBGT	Xanthidium antilopaeum
GBVZ	Thalictrum thalictroides
GCFE	Verbena hastata
GCYL	Portulaca suffruticosa
GDKK	Gloriosa superba
GDZS	Byblis gigantea
GEHT	Gleditsia triacanthos
GETL	Pogostemon sp.
GFUR	Chloromonas subdivisa
GGEA	Cedrus libani
GGJD	Strychnos spinosa
GGWH	Onychonema laeve
GHLP	Solanum dulcamara
Ginbi_v1.0	Ginkgo biloba
GIOY	Corokia cotoneaster
GIPR	Aucuba japonica
GIWN	Sarcobatus vermiculatus
GJIY	Pseudoneochloris marina
GJNX	Cypselea humifusa
GJPF	Allium sativum
GKAG	Huperzia lucidula
GKCZ	Diselma archeri
GLVK	Salix eriocephala
GMHZ	Cryptomeria japonica
Gnemo_v1.0	Gnetum montanum
GNPX	Oxera neriifolia
GNQG	Encephalartos barteri
GNRI	Digitalis purpurea
GOWD	Sphagnum lescurii
GRFT	Buddleja sp.
GRKU	Syntrichia princeps
GRRW	Grevillea robusta
GSXD	Myriopteris rufa
GSZA	Lonicera japonica
GTHK	Gnetum montanum
GTSV	Draba hispida
GUBD	Brachiomonas submarina
GUMF	Anthemis tinctoria
GVCB	Oenothera affinis
GXBM	Coccomyxa pringsheimii
GYBH	Codium fragile
GYFU	Polypodium hesperium
GYRP	Euastrum affine
HABV	Draba aizoides
HAEU	Berberidopsis beckleri
HANM	Pholisma arenarium
HAOX	Spirogyra sp.
HATH	Aristida stricta
HBGV	Sequoia sempervirens
HBHB	Aesculus pavia
HBUQ	Licania michauxii
HDSY	Aerva persica
HDWF	Francoa appendiculata
HEGQ	Gymnocarpium dryopteris
HENI	Quercus shumardii
HERT	Sphaerocarpos texanus
HFIK	Sargassum vachellianum
HGSM	Gelsemium sempervirens
HHXJ	Tetraselmis striata
HIDG	Cosmarium broomei
HILW	Acmopyle pancheri
HJMP	Astragalus membranaceus
HKMQ	Oenothera villaricae
HKZW	Mesotaenium caldariorum
HLJG	Viburnum odoratissimum
HMHL	Marchantia paleacea
HNCF	Linum hirsutum
HNDZ	Cystopteris utahensis
HOKG	Nolina atopocarpa
HPXA	Ptilidium pulcherrimum
HQOM	Torreya nucifera
HQRJ	Loropetalum chinense
HRUR	Utricularia sp.
HRWG	Buxbaumia aphylla
HTFH	Onoclea sensibilis
HTIP	Paeonia lactiflora
HUQC	Scaevola mossambicensis
HUSX	Roridula gorgonias
HVBQ	Tetraphis pellucida
HVNO	Tetraselmis chui
HWUP	Sabal bermudana
HXCD	Flaveria vaginata
HXJE	Serenoa repens
HYHN	Prasinoderma coloniale
HYZL	Akania lucens
HZTS	Sesuvium portulacastrum
IADP	Deschampsia cespitosa
IAJW	Amentotaxus argotaenia
IANR	Rosa palustris
IAYV	Rhodomonas sp.
ICNN	Yucca filamentosa
IDAU	Oenothera elata
IDGE	Heliotropium racemosum
IEHF	Dumontia simplex
IEPQ	Salix dasyclados
IFLI	Callitris gracilis
IGUH	Leucodon julaceus
IHCQ	Crossopetalum rhacoma
IHJY	Kappaphycus alvarezii
IHOI	Chloromonas oogama
IHPC	Platycodon grandiflorus
IIOL	Pinus parviflora
IJMT	Aphanochaete repens
IKFD	Quassia amara
IKIZ	Grateloupia livida
IKWM	Gracilaria lemaneiformis
ILBQ	Conocephalum conicum
IMZV	Oenothera grandis
INQX	Salix acutifolia
INSP	Myrica cerifera
IOVS	Pseudotsuga wilsoniana
IPWB	Brassica nigra
IRAF	Argemone mexicana
IRBN	Scapania nemorosa
IRYH	Heterochlamydomonas inaequalis
IRZA	Proteomonas sulcata
ISGT	Uronema sp.
ISHC	Staurastrum sebaldi
ISIM	Nephroselmis pyriformis
ISPU	Volvox globator
IUSR	Myriophyllum aquaticum
IWIS	Portulaca pilosa
IWMW	Buxus sempervirens
IXEM	Brodiaea sierrae
IXLH	Polypodium hesperium
IXVJ	Menyanthes trifoliata
IYDF	Thymus vulgaris
IZGN	Dacrydium balansae
IZLO	Lobelia siphilitica
IZNU	Ipomoea lobata
JADL	Rhynchostegium serrulatum
JAFJ	Bougainvillea spectabilis
JBLI	Bolbitis repanda
JBND	Pinus ponderosa
JCLQ	Apocynum androsaemifolium
JCMU	Pinguicula caudata
JCXF	Scytosiphon lomentaria
JDQB	Neocallitropsis pancheri
JDTY	Rhodophiala pratensis
JEBK	Eucheuma denticulatum
JEPE	Flaveria bidentis
JETM	Bauhinia tomentosa
JEXA	Impatiens balsamifera
JGAB	Mirabilis jalapa
JGGD	Sargassum muticum
JGYZ	Holarrhena pubescens
JHCN	Oxalis sp.
JHFI	Pellia neesiana
JHUL	Hemerocallis sp.
JIWJ	Acrosiphonia sp.
JJZR	Rhodochaete parvula
JKAA	Selaginella wallacei
JKHA	Cyanoptyche gloeocystis
JKKI	Lobomonas rostrata
JKNQ	Oenothera suffulta suffulta
JLOV	Pereskia aculeata
JMTE	Pseudoscourfieldia marina
JMUI	Stigeoclonium helveticum
JMXW	Bryum argenteum
JNKW	Cicerbita plumieri
JNUB	Maranta leuconeura
JNVS	Datura metel
JOIS	Koeberlinia spinosa
JOJQ	Cylindrocystis cushleckae
JPDJ	Symplocos tinctoria
JPYU	Marchantia polymorpha
JQFK	Picochlorum atomus
JRGZ	Chlamydomonas moewusii
JRNA	Phyllocladus hypophyllus
JSAG	Masdevallia yuangensis
JSZD	Bursera simaruba
JTIG	Bryopsis plumosa
JTQQ	Glycyrrhiza lepidota
JTRM	Dipsacus asper
JUWL	Keteleeria evelyniana
JVBR	Aloe vera
JVSZ	Equisetum hyemale
JWEY	Heliotropium tenuifolium
JWGT	Volvox aureus
JYMN	Flaveria brownii
JZVE	Parasitaxus usta
KADG	Ignatius tetrasporus
KAWQ	Stangeria eriopus
KAYP	Lindera benzoin
KBRW	Oenothera clelandii
KBXS	Allium commutatum
KCPT	Linum macraei
KDCH	Portulaca umbraticola
KEFD	Encalypta streptocarpa
KEGA	Glycine soja
KEYW	Gonatozygon kinahanii
KFEB	Haematococcus pluvialis
KFZY	Tragopogon castellanus
KGJF	Tragopogon porrifolius
KIIX	Pilularia globulifera
KJAA	Mollugo pentaphylla
KJYC	Selaginella willdenowii
KJZG	Asplenium platyneuron
KKDQ	Salix viminalis
KLGF	Sundacarpus amarus
KMNX	Nucleotaenium eifelense
KNMB	Lathyrus sativus
KOFB	Urginea maritima
KPTE	Bixa orellana
KPUM	Exacum affine
KRJP	Peumus boldus
KRUQ	Porella navicularis
KSFK	Desmochloris halophila
KTAR	Chionanthus retusus
KTWL	unknown
KUJU	Gonium pectorale
KUXM	Selaginella selaginoides
KVAY	Tribulus eichlerianus
KVFU	Diospyros malabarica
KWGC	Crassula perforata
KXSK	Agave tequilana
KYAD	Celtis occidentalis
KYIO	Mesostigma viride
KYNE	Cyanella orchidiformis
KZED	Senna hebecarpa
'Klefl_v1.0'	Klebsormidium flaccidum
LAPO	Draba oligosperma
LBRP	Chloromonas reticulata
LDEL	Portulaca amilis
LDME	Amaryllis belladonna
LDRY	Sargassum fusiforme
LELS	Haemaria discolor
LEMW	Curcuma longa
LETF	Planophila sp
LFOG	Salix purpurea
LGDQ	Selaginella apoda
LGOW	Schistochila sp.
LHLE	Cystopteris fragilis
LIRF	Dictyopteris undulata
LJPN	Gracilaria blodgettii
LJQF	Draba ossetica
LKKX	Talinum sp.
LLEN	Pavlova lutheri
LLQV	Portulaca cryptopetala
LLXJ	Chroodactylon ornatum
LNER	Casuarina equisetifolia
LNIL	Pteromonas angulosa
LNSF	Stereodon subimponens
LPGY	Viola tricolor
LQJY	Solanum xanthocarpum
LRRR	Teucrium chamaedrys
LRTN	Monotropa uniflora
LSHT	Bolbocoleon piliferum
LSJW	Ruscus sp.
LSKK	Orchidantha maxillarioides
LTZF	Sisyrinchium angustifolium
LVUS	Cleome violacea
LWCK	Lycium barbarum
LWDA	Alnus serrulata
LXRN	Prymnesium parvum
LYPZ	Flaveria pubescens
Marpo_v1.0	Marchantia polymorpha
MAQO	Gomortega keule
MCHJ	Micrasterias fimbriata
MCPK	Bathycoccus prasinos
MDJK	Heliotropium texanum
MEKP	Dipteris conjugata
MFEA	Stackhousia spathulata
MFIN	Pistia stratiotes
MFTM	Pinus jeffreyi
MFYC	Nannochloris atomus
MFZO	Zygnemopsis sp.
MGVU	Allamanda cathartica
MHGD	Microcachrys tetragona
MHYG	Conyza canadensis
MIRS	Climacium dendroides
MIXZ	Agathis robusta
MKZR	Nicotiana sylvestris
MMKU	Nephroselmis olivacea
MNCB	Eremosphaera viridis
MNNM	Cosmarium granatum
MOYY	Pleurotaenium trabecula
MQIV	Phyla dulcis
MRKX	Phytolacca bogotensis
MROH	Thelypteris acuminata
MTGC	Dennstaedtia davallioides
MTHW	Platanthera clavellata
MTII	Acorus americanus
MULF	Chlamydomonas bilatus
MUMD	Lomandra longifolia
MUNP	Piper auritum
MVRF	Sansevieria trifasciata
MVSE	Griselinia littoralis
MWAN	Neodesmus pupukensis
MWXT	Chara vulgaris
MWYQ	Smilax bona-nox
MXDS	Spermatozopsis exsultans
MXFG	Pinguicula agnata
MYMP	Astragalus propinquus
MYVH	Linum grandiflorum
MYZV	Tropaeolum peregrinum
MZLD	Ligustrum sinense
MZOB	Heliotropium mendocinum
'Manes_v4.1'	Manihot esculenta
'Micpu_v3.0'	Micromonas pusilla
'Mimgu_v2.0'	Mimulus guttatus
'Musac_v1.0'	Musa acuminata
NATT	Trentepohlia annulata
NAUM	Ipomoea lindheimeri
NBMW	Sanchezia sp.
NBYP	Mesotaenium kramstae
NCVK	Prunus prostrata
NDUV	Vittaria appalachiana
NEBM	Syzygium micranthum
NFXV	Mammea americana
NGRR	Ternstroemia gymnanthera
NGTD	Dicranum scoparium
NHAG	Ipomoea nil
NHCM	Angiopteris evecta
NHIX	Colchicum autumnale
NHUA	Castanea crenata
NIGS	Heliotropium karwinskyi
NJLF	Viola canadensis
NKIN	Thujopsis dolabrata
NKXU	Trebouxia arboricola
NMAK	Pavlova lutheri
NMDZ	Solanum sisymbriifolium
NMGG	Hypecoum procumbens
NNGU	Coriaria nepalensis
NNHQ	Spirotaenia minuta
NNOK	Neurachne tenuifolia
NOKI	Lindsaea linearis
NPND	Ceratophyllum demersum
NPRL	Cathaya argyrophylla
NQYP	Pirula salina
NRWZ	Metzgeria crassipilis
NRXL	Metasequoia glyptostroboides
NSPR	Nypa fruticans
NSTT	Oltmannsiellopsis viridis
NTEO	Pittosporum sahnianum
NUZN	Cercidiphyllum japonicum
NVGZ	Cephalotaxus harringtonia
NVSO	Flaveria palmeri
NWMY	Kadsura heteroclita
NWWI	Nephrolepis exaltata
NXOH	Apios americana
NXTS	Mollugo verticillata
'Nelnu_v1.0'	Nelumbo nucifera
OAEZ	Percursaria percursa
OAGK	Matricaria matricarioides
OBPL	Myristica fragrans
OBTI	Peganum harmala
OBUY	Porphyridium cruentum
OCTM	Begonia sp.
OCWZ	Dioscorea villosa
OCZL	Homalosorus pycnocarpos
ODDO	Ardisia humilis
OEKO	Heliotropium filiforme
OFTV	Barbilophozia barbata
OFUE	Lobochlamys segnis
OHAE	Polygala lutea
OHKC	Alternanthera caracasana
OINM	Hydrocotyle umbellata
OLES	Schiedea membranacea
OLXF	Hibiscus cannabinus
OMDH	Loropetalum chinense
OMYK	Trianthema portulacastrum
ONBE	Eriospermum lancifolia
ONLQ	Atriplex hortensis
OODC	Linum bienne
OOSO	Helonias bullata
OOVX	Boykinia jamesii
OPDF	Saururus cernuus
OQBM	Ipomoea indica
OQHZ	Quillaja saponaria
OQON	Entocladia endozoica
OQWW	Davallia fejeensis
ORJE	Phymatosorus grossus
ORKS	Philonotis fontana
OSHQ	Sarcandra glabra
OSIP	Garcinia livingstonei
OSMU	Lycium sp.
OTQG	Ankistrodesmus sp.
OUER	Heliotropium convolvulaceum
OVIJ	Papuacedrus papuana
OWAS	Rehmannia glutinosa
OWFC	Halocarpus bidwillii
OXGJ	Glyptostrobus pensilis
OXYP	Sideroxylon reclinatum
'Orysa_v7.0'	Oryza sativa
'Ostlu_v2.0'	Ostreococcus lucimarinus
PAWA	Aristolochia elegans
PAZJ	Ricinus communis
PBUU	Lygodium japonicum
PCGJ	Anisacanthus quadrifidus
PCNH	Psychotria marginata
PDQH	Aerva lanata
PEZP	Glycyrrhiza glabra
PFUD	Geminella sp.
PHCE	Prunella vulgaris
PIUF	Pellia cf. epiphylla
PIVW	Ceratopteris thalictroides
PJSX	Acacia pycnantha
PKMO	Cistus inflatus
PKOX	Isoetes tegetiformans
PLBZ	Chlorogalum pomeridianum
PMTB	Oenothera gaura
PNZO	Culcita macrocarpa
POOW	Glaucocystis cf. nostochinearum
POPJ	Pteris vittata
POZS	Linum usitatissimum
PPPZ	Rhododendron scopulorum
PPQR	Typha angustifolia
PQED	Gloeochaete wittrockiana
PQTO	Lycopodium deuterodensum
PRFO	Agapanthus africanus
PRIQ	Pleurastrum insigne
PSHB	Lantana camara
PSJT	Uvaria microcarpa
PSKY	Asplenium nidus
PTBJ	Plantago virginica
PTFA	Jacquinia sp.
PTLU	Staphylea trifolia
PUAN	Chlorochytridion tuberculata
PUCW	Agastache rugosa
PUDI	Daphne giraldii
PVGP	Porphyridium purpureum
PWKQ	Gracilaria sp.
PWSG	Cyperus papyrus
PXYR	Euphorbia pekinensis
PYDB	Grateloupia catenata
PYHZ	Isoetes sp.
PZIF	Acutodesmus dimorphus
PZRT	Nymphaea sp.
'Phavu_v1.0'	Phaseolus vulgaris
'Phypa_v3.0'	Physcomitrella patens
'Pinta_v2.0'	Pinus taeda
'Poptr_v3.0'	Populus trichocarpa
'Prupe_v1.0'	Prunus persica
QACK	Helwingia japonica
QAUE	Actinidia chinensis
QCGM	Saxegothaea conspicua
QCOU	Papaver setigerum
QDVW	Saruma henryi
QEHE	Rauvolfia tetraphylla
QFAE	Sequoiadendron giganteum
QFND	Cyanophora paradoxa
QHBI	Falcatifolium taxoides
QIAD	Hymenophyllum bivalve
QICX	Ailanthus altissima
QIEH	Cotoneaster transcaucasicus
QIKZ	Griselinia racemosa
QKMG	Phoradendron serotinum
QKQO	Pseudotaxiphyllum elegans
QLMZ	Colpomenia sinuosa
QMWB	Anomodon attenuatus
QNGJ	Cupressus dupreziana
QNOC	Sanguisorba minor
QNPH	Colchicum autumnale
QOXT	Xerophyta villosa
QPDY	Coleochaete irregularis
QRTH	Chloromonas perforata
QSKP	Polanisia trachysperma
QSLH	Ipomoea hederacea
QSNJ	Taiwania cryptomerioides
QTJY	Euptelea pleiosperma
QURC	Dichroa febrifuga
QUTB	Aextoxicon punctatum
QVMR	Psilotum nudum
QWFV	Bambusina borreri
QWRA	Vitreochlamys sp.
QXSZ	Mantoniella squamata
QXWF	Flaveria kochiana
QYXY	Botryococcus terribilis
QZXQ	Gymnocladus dioicus
QZZU	Pyrenacantha malvifolia
RAPY	Saccharina sculpera
RAWF	Uronema belkae
RBYC	Elaeagnus pungens
RCAH	Uniola paniculata
RCBT	Sphagnum palustre
RCUX	Maianthemum sp.
RDOO	Racomitrium varium
RDYY	Cyanastrum cordifolium
RFAD	Pavlova lutheri
RFMZ	Osmundastrum cinnamomeum
RFRB	Didymochlaena truncatula
RFSD	Lactuca graminifolia
RGKI	Leucobryum glaucum
RHAU	Euphorbia mesembryanthemifolia
RHVC	Dunaliella salina
RICC	Cystopteris reevesiana
RJIM	Melia azedarach
RJNQ	Lagerstroemia indica
RKFX	Cercis canadensis
RKLL	Copaifera officinalis
RMMV	Callitris macleayana
RMVB	Avena fatua
RMWJ	Wisteria floribunda
RNAT	Eudorina elegans
RNBN	Mollugo cerviana
ROEI	Cymbopogon nardus
ROLB	Oenothera elata
ROWR	Falcatifolium taxoides
ROZZ	Chroomonas sp.
RPGL	Cylindrocystis brebissonii
RPPC	Erythroxylum coca
RPQV	Phymatodocis nordstedtiana
RPRU	Staurodesmus omearii
RQFE	Cosmocladium cf. constrictum
RQNK	Papaver somniferum
RQUG	Hakea prostrata
RQZP	Nolina bigelovii
RRSV	Pedinomonas minor
RSCE	Wollemia nobilis
RSOF	Glaucosphaera vacuolata
RSPO	Santalum acuminatum
RTLC	Rhodella violacea
RTMU	Calypogeia fissa
RTNA	Oxera pulchella
RTTY	Salvadora sp.
RUIF	Carteria obtusa
RUUB	Physena madagascariensis
RVGH	Drypetes deplanchei
RWKR	Saintpaulia ionantha
RWXW	Sargassum horneri
RXEN	Polycarpaea repens
RYJX	Pandorina morum
RZTJ	Salix fargesii
SALZ	Pittosporum resiniferum
SART	Xeronema callistemon
SBLT	Gloiopeltis furcata
SBZH	Pennantia corymbosa
SCAO	Mollugo nudicaulis
SCEB	Podocarpus coriaceus
SDPC	Oedogonium foveolatum
SERM	Sarcodes sanguinea
SFKQ	Hilleria latifolia
SGTW	Ginkgo biloba
SHEZ	Dianthus caryophyllus
SIBR	Celsia arcturus
SIIK	Hakea drupacea
SILJ	Talbotia elegans
SIZE	Passiflora caerulea
SJAN	Oenothera serrulata
SJEV	Canella winterana
SKNL	Saponaria officinalis
SKQD	Takakia lepidozioides
SKYV	Vittaria lineata
SLOI	Tiarella polyphylla
SLYR	Cladrastis lutea
SMMC	Chenopodium quinoa
SMUR	Lennoa madreporoides
SNNC	Leonurus japonicus
SNOX	Planotaenium ohtanii
SOHV	Panicum miliaceum
SQCF	Dryas octopetala
SRSQ	Saccharina japonica
SSDU	Papaver bracteatum
STKJ	Cosmarium ochthodes
SUAK	Codariocalyx motorius
SUVN	Hedera helix
SVTS	Drimia altissima
SVVG	Fagus sylvatica
SWGX	Tetrazygia bicolor
SWOH	Trochodendron aralioides
SWPE	Reseda odorata
SXCE	Physocarpus opulifolius
SXML	Ilex paraguariensis
SYHW	Ribes aff. giraldii
SYJM	Dunaliella salina
SZPD	Tetrastigma voinierianum
SZUO	Eucommia ulmoides
SZYG	Polytrichum commune
'Selmo_v1.0'	Selaginella moellendorffii
'Solly_iTAGv2.3'	Solanum lycopersicum
'Sorbi_v2.1'	Sorghum bicolor
Spipo_v2	Spirodela polyrhiza
TAGM	Melissa officinalis
TAVP	Calliergon cordifolium
TCBC	Nothoceros vincentianus
TCYS	Peliosanthes minor
TDTF	Salix sachalinensis
TEZA	Solidago canadensis
TFYI	Marchantia emarginata
TGKW	Frullania sp.
TGNL	Picocystis salinarum
THDM	Vanilla planifolia
THEW	Lilium sargentiae
THHD	Elaeocarpus sylvestris
TIUZ	Cunonia capensis
TJES	Spergularia media
TJLC	Nothofagus obliqua
TJQY	Kerria japonica
TKEK	Mansoa alliacea
TLCA	Oenothera speciosa
TMAJ	Neckera douglasii
TNAW	Pyramimonas parkeae
TOKV	Aphanopetalum resinosum
TORX	Olea europaea
TOXE	Welwitschia mirabilis
TPEM	Platyspermation crassifolium
TPHT	Spirotaenia sp.
TQKZ	Angelica archangelica
TRRQ	Narcissus viridiflorus
TSBQ	Chlamydomonas sp.
TTRG	Lupinus angustifolius
TVCU	Ochna mossambicensis
TVSH	Bituminaria bituminosa
TWUW	Anthoceros agrestis
TXMP	Linum strictum
TXVB	Lunularia cruciata
TZNS	Canna sp.
TZWR	Arabis alpina
'Theca_v1.1'	Theobroma cacao
UAXP	Gyrostemon ramulosus
UBLN	Xanthium strumarium
UCNM	Ajuga reptans
UCRN	Megaceros flagellaris
UDHA	Ceratocapnos vesicaria
UDUT	Larrea tridentata
UEVI	Fokienia hodginsii
UFHF	Galax urceolata
UFJN	Diplazium wichurae
UGJI	Lycopersicon cheesmanii
UGNK	Marattia attenuata
UGPM	Chondrus crispus
UHBY	Oresitrophe rupifraga
UHJR	Citrus x paradisi
UHLI	Sphagnum recurvum
UJGI	Oenothera rosea
UJTT	Pityrogramma trifoliata
UJWU	Pleopeltis polypodioides
UKUC	Dunaliella salina
ULKT	Lycopodiella appressa
ULXR	Scytosiphon dotyi
UMUL	Paulownia fargesii
UOEL	Strelitzia reginae
UOMY	Osmunda sp.
UOYN	Catharanthus roseus
UPMJ	Pseudolycopodiella caroliniana
UPOG	Anemone pulsatilla
UPZX	Cleome viscosa
UQCB	Portulaca molokiniensis
URCP	Athyrium filix-femina
URDJ	Amborella trichopoda
URSB	Grateloupia turuturu
USIX	Neochlorosarcina sp.
UTQR	Tabebuia umbellata
UTRE	Chloromonas tughillensis
UUHD	Porella pinnata
UUJS	Nageia nagi
UVDC	Azadirachta indica
UVQL	Draba magellanica
UWFU	Itea virginica
UWOD	Plagiogyria japonica
UYED	Flaveria sonorensis
UYFR	Symphyocladia latiuscula
UZWG	Castanea pumila
UZXL	Disporopsis pernyi
VALZ	Chlamydomonas noctigama
VAZE	Cylindrocystis sp.
VBHQ	Stemona tuberosa
VBLH	Cladophora glomerata
VBMM	Claopodium rostratum
VCIN	Malus baccata
VDAO	Ephedra sinica
VDKG	Cleome gynandra
VFFP	Acer negundo
VFIV	Fritschiella tuberosa
VFYZ	Thuja plicata
VGHH	Hydrastis canadensis
VGSX	Retrophyllum minus
VGVI	Dendropemon caribaeus
VHIJ	Blastophysa cf. rhizopus
VHZV	Gleditsia sinensis
VIAU	Carteria crucifera
VIBO	Osmunda javanica
VITX	Blechnum spicant
VJDZ	Botryosphaerella sudetica
VJED	Pavlova lutheri
VJPU	Boerhavia dominii
VKJD	Maesa lanceolata
VKVG	Synura sp.
VLNB	Gompholobium polymorphum
VMNH	Sinapis alba
VMXJ	Leucobryum albidum
VNAL	Gracilaria vermiculophylla
VNMY	Bischofia javanica
VQBJ	Coleochaete scutata
VQFW	Platanus occidentalis
VQYB	Neurachne lanigera
VRGZ	Petalonia fascia
VSRH	Abies lasiocarpa
VTLJ	Caiophora chuquitensis
VTUS	Goodyera pubescens
VUSY	Nyssa ogeche
VVPY	Croton tiglium
VVRN	Lonchitis hirsuta
VVVV	Ludovia sp.
VXKB	Ipomoea purpurea
VXOD	Linum tenuifolium
VYDM	Orobanche fasciculata
VYER	Sargassum hemiphyllum
VYGG	Stachyurus praecox
VYLQ	Cassytha filiformis
VZCI	Illicium floridanum
VZWX	Ceramium kondoi
'Vitvi_Genoscope.12X'	Vitis vinifera
'Volca_v2.0'	Volvox carteri
WAFT	Diphasiastrum digitatum
WAIL	Laurelia sempervirens
WAXR	Litchi chinensis
WBIB	Lepidosperma gibsonii
WBOD	Magnolia grandiflora
WCLG	Adiantum aleuticum
WCLV	Prasiola crispa
WCOR	Thyridolepis multiculmis
WCQU	Staurodesmus convergens
WCZB	Phaeoceros carolinianus
WDCW	Mesotaenium endlicherianum
WDGV	Cosmarium subtumidum
WDWX	Dunaliella primolecta
WEAC	Strobilanthes dyeriana
WEEQ	Phaeoceros carolinianus
WEJN	Mazzaella japonica
WEQK	Centella asiatica
WFBF	Podophyllum peltatum
WGET	Kochia scoparia
WGTU	Leucostegia immersa
WHNV	Micromeria fruticosa
WIGA	Persea borbonia
WJLO	Ricciocarpos natans
WKCY	Urtica dioica
WKSU	Drimys winteri
WLIC	Dioon edule
WMLW	Amaranthus retroflexus
WMUK	Schizolaena sp.
WNGH	Aulacomnium heterostichum
WOBD	Limonium spectabile
WOGB	Andreaea rupestris
WOHL	Schlegelia parasitica
WPHN	Idiospermum australiense
WQML	Cryptogramma acrostichoides
WQRD	Galium boreale
WQUF	Nepenthes alata
WRPP	Synsepalum dulcificum
WRSL	Volvox aureus
WSJO	Mesotaenium braunii
WSPM	Loeskeobryum brevirostre
WTDE	Johnsonia pubescens
WTKZ	Nuphar advena
WVEF	Rhamnus caroliniana
WVMY	Phlox drummondii
WVWN	Larix speciosa
WWKL	Tapiscia sinensis
WWQZ	Medinilla magnifica
WWSS	Taxus baccata
WXNT	Joinvillea ascendens
WXRI	Stichococcus bacillaris
WXVX	Ledum palustre
WYIG	Dombeya burgessiae
WZFE	Ascarina rubricaulis
WZYK	Bazzania trilobata
XAXW	Neosiphonia japonica
XAYK	Kigelia africana
XBKS	Thyridolepis mitchelliana
XDDT	Argyrochosma nivea
XDLL	Oogamochlamys gigantea
XFFT	Cercocarpus ledifolius
XFJG	Maianthemum canadense
XGFU	Exocarpos cupressiformis
XHHU	Heliconia sp.
XHKT	Sanguinaria canadensis
XIRK	Athrotaxis cupressoides
XISJ	Antirrhinum majus
XIVI	Cymbomonas sp.
XJGM	coccoid-prasinophyte
XKPS	Ximenia americana
XKWQ	Pediastrum duplex
XLGK	Podocarpus rubens
XMBA	Poliomintha bustamanta
XMCL	Prasinococcus capsulatus
XMGP	Juniperus scopulorum
XMQO	Gunnera manicata
XMVD	Chelidonium majus
XNLP	Manihot grahamii
XNXF	Dendrolycopodium obscurum
XOAL	Dolichomastix tenuilepis
XOOE	Desmanthus illinoensis
XPAF	Mapania palustris
XPBC	Galphimia gracilis
XQRV	Ipomoea purpurea
XQSG	Microbiota decussata
XQWC	Michelia maudiae
XRCX	Aster tataricus
XRLM	Buddleja lindleyana
XRTZ	Roya obtusa
XSSD	Amaranthus cruentus
XSZI	Peperomia fraseri
XTON	Pediastrum duplex
XTZO	Araucaria rulei
XUAB	Paraneurachne muelleri
XVJB	Morus nigra
XVRU	Heliotropium calcicola
XWHK	Rosulabryum cf. capillare
XXHP	Cystopteris fragilis
XXYA	Verbascum sp.
XZME	Drakaea elastica
XZUY	Cycas micholitzii
YADI	Asclepias syriaca
YBML	Yucca brevifolia
YBQN	Odontoschisma prostratum
YCKE	Notholaena montieliae
YDCQ	Cephaleuros virescens
YEPO	Physcomitrium sp.
YFGP	Pallavicinia lyellii
YFQX	Apocynum androsaemifolium
YFZK	Sciadopitys verticillata
YGAT	Phyllanthus sp.
YGCX	Geranium maculatum
YHFG	Nandina domestica
YHLF	Oenothera rhombipetala
YHZW	Huperzia selago
YIXP	Lindsaea microphylla
YJJY	Woodsia scopulina
YJUG	Curculigo sp.
YKFU	Peltoboykinia watanabei
YKQR	Hamamelis virginiana
YKZB	Plantago maritima
YLJA	Polypodium amorphum
YLPM	Pseudotaxus chienii
YLWW	Uniola paniculata
YMES	Typhonium blumei
YNFJ	Microtea debilis
YNUE	Punica granatum
YOWV	Cystopteris protrusa
YOXI	Cylindrocystis brebissonii
YPIC	Microstegium vimineum
YQEC	Woodsia ilvensis
YQIJ	Phacelia campanularia
YRBQ	Flaveria angustifolia
YRHD	Antirrhinum braun-blanquetii
YRMA	Sargassum thunbergii
YSBD	Heterosiphonia pulchra
YSQT	Penium exiguum
YSRZ	Fouquieria macdougalii
YUOM	Rhus radicans
YWNF	Hedwigia ciliata
YXNR	Triodia aff. bynoei
YYPE	Austrocedrus chilensis
YZGX	unknown
YZRI	Annona muricata
YZVJ	Cephalotus follicularis
ZACW	Leucodon brachypus
ZBPY	Alternanthera brasiliana
ZBTA	Boerhavia coccinea
ZBVT	Chrysobalanus icaco
ZCDJ	Acacia argyrophylla
ZCUA	Flaveria trinervia
ZDIZ	Dunaliella tertiolecta
ZENX	Neurachne alopecuroidea
ZETY	Hydrangea quercifolia
ZFGK	Selaginella kraussiana
ZFXU	Asteromonas gracilis
ZGQD	Corydalis linstowiana
ZHEE	Ziziphus jujuba
ZHMB	Krameria lanceolata
ZINQ	Oenothera grandiflora
ZIVZ	Phacotus lenticularis
ZIWB	Passiflora_sp
ZJOJ	Grateloupia filicina
ZJRC	Sambucus canadensis
ZJUL	Rhodiola rosea
ZKPF	Traubia modesta
ZLQE	Stephanosphaera pluvialis
ZMGN	Neurachne munroi
ZNUM	Leptosira obovata
ZPKK	Aruncus dioicus
ZQRI	Timmia austriaca
ZQVF	Cunninghamia lanceolata
ZQWM	Lagarostrobos franklinii
ZQYU	Phlebodium pseudoaureum
ZRIN	Uncarina grandidieri
ZRMT	Mougeotia sp.
ZSAB	Hoheria angustifolia
ZSGF	Psychotria ipecacuanha
ZSSR	Xanthocercis zambesiaca
ZTHV	Atrichum angustatum
ZTLR	Rhizophora mangle
ZUHO	Anemone hupehensis
ZULJ	Pyropia yezoensis
ZXJO	Parahemionitis cordata
ZYAX	Taxus cuspidata
ZYCD	Selaginella acanthonota
ZZEI	Phylloglossum drummondii
ZZOL	Selaginella moellendorffii
